sim_num,rate_num,ratio,trace,score,var_fin,learn_time,n_selected,n_pruned
0,0,5,True,57.0,0.0,5.800000000000001,5,0
0,0,5,False,49.0,0.0,5.800000000000001,5,0
0,0,10,True,42.0,0.0,5.800000000000001,10,0
0,0,10,False,47.0,0.0,5.800000000000001,10,0
0,0,15,True,55.0,0.0,5.800000000000001,15,0
0,0,15,False,47.0,0.0,5.800000000000001,15,0
0,0,20,True,52.0,0.0,5.800000000000001,20,0
0,0,20,False,44.0,0.0,5.800000000000001,20,0
0,0,25,True,56.0,0.0,5.800000000000001,25,0
0,0,25,False,97.0,0.07737322180996768,92.9,13,12
0,0,30,True,54.0,0.0,5.800000000000001,30,0
0,0,30,False,98.0,0.10990958479783051,83.7,15,15
0,0,35,True,59.0,0.0,5.800000000000001,35,0
0,0,35,False,98.0,0.11872879527513598,69.65,17,18
0,0,40,True,56.0,0.0,5.800000000000001,40,0
0,0,40,False,98.0,0.14171537252129904,89.65,20,20
0,0,45,True,61.0,0.0,5.800000000000001,45,0
0,0,45,False,96.0,0.15093725408389005,46.650000000000006,23,22
0,0,50,True,51.0,0.0,5.800000000000001,50,0
0,0,50,False,98.0,0.17489275297489,,25,25
0,0,55,True,45.0,0.09755875474805677,275.65000000000003,28,27
0,0,55,False,100.0,0.2709930424644191,99.0,27,28
0,0,60,True,59.0,0.0035167716698406085,,30,30
0,0,60,False,97.0,0.22522525138989363,95.10000000000001,30,30
0,0,65,True,56.0,0.004031555694008366,196.55,33,32
0,0,65,False,98.0,0.20472239032833517,151.75,32,33
0,0,70,True,54.0,0.00023418372293781625,134.05,2,68
0,0,70,False,99.0,0.22698079147194533,112.25,35,35
0,0,75,True,49.0,0.0042691709299327715,179.15,38,37
0,0,75,False,59.0,0.0279025329789279,,75,0
0,0,80,True,54.0,0.002845563005146532,132.05,40,40
0,0,80,False,97.0,0.20540150150717632,143.45000000000002,40,40
0,0,85,True,57.0,0.005949901067375544,91.0,44,41
0,0,85,False,98.0,0.23429988778200858,102.10000000000001,42,43
0,0,90,True,48.0,0.000743879268074803,128.25,77,13
0,0,90,False,98.0,0.22779833268285063,61.1,45,45
0,0,95,True,50.0,0.00017217837189886095,112.95,48,47
0,0,95,False,99.0,0.2423185999274537,99.30000000000001,47,48
0,0,100,True,53.0,0.01657452130078851,192.65,95,5
0,0,100,False,98.0,0.2094340323185138,75.05,50,50
0,1,5,True,53.0,0.0,5.800000000000001,5,0
0,1,5,False,50.0,0.0,5.800000000000001,5,0
0,1,10,True,63.0,0.0,5.800000000000001,10,0
0,1,10,False,54.0,0.0,5.800000000000001,10,0
0,1,15,True,50.0,0.0,5.800000000000001,15,0
0,1,15,False,50.0,0.0,5.800000000000001,15,0
0,1,20,True,58.0,0.0,5.800000000000001,20,0
0,1,20,False,48.0,0.0,5.800000000000001,20,0
0,1,25,True,57.0,0.0,5.800000000000001,25,0
0,1,25,False,98.0,0.07335491608639123,15.9,12,13
0,1,30,True,52.0,0.0,5.800000000000001,30,0
0,1,30,False,98.0,0.10534781676475867,95.65,15,15
0,1,35,True,58.0,0.0,5.800000000000001,35,0
0,1,35,False,96.0,0.1172343391973333,94.95,18,17
0,1,40,True,55.0,0.0,5.800000000000001,40,0
0,1,40,False,98.0,0.14908023703157322,97.65,20,20
0,1,45,True,53.0,0.0,5.800000000000001,45,0
0,1,45,False,53.0,0.1588315806069027,108.15,22,23
0,1,50,True,48.0,0.0,5.800000000000001,50,0
0,1,50,False,42.0,0.16555689758908998,62.650000000000006,32,18
0,1,55,True,51.0,0.0,5.800000000000001,55,0
0,1,55,False,51.0,0.161298759433064,78.45,33,22
0,1,60,True,55.0,0.0,5.800000000000001,60,0
0,1,60,False,43.0,0.1595236805560324,53.0,37,23
0,1,65,True,57.0,0.0,5.800000000000001,65,0
0,1,65,False,46.0,0.16039094785731803,98.0,38,27
0,1,70,True,45.0,0.0,5.800000000000001,70,0
0,1,70,False,46.0,0.17322150908535605,73.15,42,28
0,1,75,True,39.0,0.0,5.800000000000001,75,0
0,1,75,False,49.0,0.17366844275879745,141.65,44,31
0,1,80,True,57.0,0.0,5.800000000000001,80,0
0,1,80,False,40.0,0.18264807882137116,162.8,46,34
0,1,85,True,56.0,0.0,5.800000000000001,85,0
0,1,85,False,46.0,0.18867727394860156,67.55,46,39
0,1,90,True,51.0,0.0,5.800000000000001,90,0
0,1,90,False,53.0,0.19670033008891233,78.0,45,45
0,1,95,True,54.0,0.0,5.800000000000001,95,0
0,1,95,False,45.0,0.20299329139357747,62.7,47,48
0,1,100,True,47.0,0.0,5.800000000000001,100,0
0,1,100,False,100.0,0.22020624480246653,136.75,50,50
0,2,5,True,53.0,0.0,5.800000000000001,5,0
0,2,5,False,52.0,0.0,5.800000000000001,5,0
0,2,10,True,46.0,0.0,5.800000000000001,10,0
0,2,10,False,43.0,0.0,5.800000000000001,10,0
0,2,15,True,54.0,0.0,5.800000000000001,15,0
0,2,15,False,53.0,0.0,5.800000000000001,15,0
0,2,20,True,61.0,0.0,5.800000000000001,20,0
0,2,20,False,47.0,0.0,5.800000000000001,20,0
0,2,25,True,51.0,0.0,5.800000000000001,25,0
0,2,25,False,98.0,0.07691819312998523,125.30000000000001,12,13
0,2,30,True,55.0,0.0,5.800000000000001,30,0
0,2,30,False,98.0,0.11108369748586416,100.45,15,15
0,2,35,True,63.0,0.0,5.800000000000001,35,0
0,2,35,False,98.0,0.12844591854572754,102.05000000000001,17,18
0,2,40,True,51.0,0.010838632196567236,,20,20
0,2,40,False,99.0,0.15769437463954916,102.35000000000001,20,20
0,2,45,True,61.0,0.004696441001135792,257.5,23,22
0,2,45,False,98.0,0.1583720131993827,129.9,22,23
0,2,50,True,61.0,0.0010604921584304423,,25,25
0,2,50,False,99.0,0.17490322196424515,69.65,25,25
0,2,55,True,52.0,0.0023368642910748753,,54,1
0,2,55,False,100.0,0.17679400648944954,87.05000000000001,27,28
0,2,60,True,54.0,0.0,5.800000000000001,60,0
0,2,60,False,100.0,0.19107269995932552,132.25,30,30
0,2,65,True,48.0,0.0,5.800000000000001,65,0
0,2,65,False,100.0,0.1908912039455757,45.25,32,33
0,2,70,True,53.0,0.0,5.800000000000001,70,0
0,2,70,False,100.0,0.1985024503910848,130.9,35,35
0,2,75,True,46.0,0.0,5.800000000000001,75,0
0,2,75,False,100.0,0.19612847664835223,51.45,38,37
0,2,80,True,58.0,0.0,5.800000000000001,80,0
0,2,80,False,100.0,0.2113312530843557,,40,40
0,2,85,True,58.0,0.0,5.800000000000001,85,0
0,2,85,False,100.0,0.2091573298204754,97.80000000000001,42,43
0,2,90,True,59.0,0.0,5.800000000000001,90,0
0,2,90,False,100.0,0.2130895242751173,105.80000000000001,45,45
0,2,95,True,55.0,0.0,5.800000000000001,95,0
0,2,95,False,99.0,0.21206138834331767,168.0,48,47
0,2,100,True,57.0,0.0,5.800000000000001,100,0
0,2,100,False,99.0,0.21461852594542566,206.15,50,50
0,3,5,True,58.0,0.0,5.800000000000001,5,0
0,3,5,False,53.0,0.0,5.800000000000001,5,0
0,3,10,True,62.0,0.0,5.800000000000001,10,0
0,3,10,False,55.0,0.0,5.800000000000001,10,0
0,3,15,True,52.0,0.0,5.800000000000001,15,0
0,3,15,False,52.0,0.0,5.800000000000001,15,0
0,3,20,True,56.0,0.0,5.800000000000001,20,0
0,3,20,False,55.0,0.0,5.800000000000001,20,0
0,3,25,True,58.0,0.0,5.800000000000001,25,0
0,3,25,False,97.0,0.07436353648333348,94.05000000000001,13,12
0,3,30,True,49.0,0.0,5.800000000000001,30,0
0,3,30,False,98.0,0.1063155516821873,107.15,15,15
0,3,35,True,63.0,7.345031995078108e-05,161.05,29,6
0,3,35,False,96.0,0.1135194166872843,176.85000000000002,18,17
0,3,40,True,56.0,0.0018086898964891312,,20,20
0,3,40,False,98.0,0.1586707803269548,78.2,20,20
0,3,45,True,49.0,0.0016192176245870037,135.75,23,22
0,3,45,False,97.0,0.15197778352070815,91.4,23,22
0,3,50,True,56.0,0.016556129385687283,,25,25
0,3,50,False,100.0,0.24974966428957282,144.45000000000002,25,25
0,3,55,True,52.0,0.013587322234874298,139.70000000000002,27,28
0,3,55,False,47.0,0.031543748152164375,66.3,55,0
0,3,60,True,50.0,0.013863522474390258,155.70000000000002,30,30
0,3,60,False,100.0,0.2510314718852447,266.55,30,30
0,3,65,True,62.0,0.07410905729176141,,33,32
0,3,65,False,53.0,0.07506759680028531,53.2,64,1
0,3,70,True,51.0,0.027799942812994503,195.05,64,6
0,3,70,False,41.0,0.136972567417198,89.45,39,31
0,3,75,True,57.0,0.015924061834602765,180.5,37,38
0,3,75,False,98.0,0.20569552052032747,263.40000000000003,37,38
0,3,80,True,50.0,0.033130061851745544,230.45000000000002,40,40
0,3,80,False,96.0,0.20630825961023988,187.95000000000002,40,40
0,3,85,True,53.0,0.0036103230768588096,116.9,31,54
0,3,85,False,62.0,0.003361440809130478,151.15,0,85
0,3,90,True,50.0,0.1719104995044813,130.5,45,45
0,3,90,False,93.0,0.21414198526699135,,45,45
0,3,95,True,60.0,0.0369164912566063,,93,2
0,3,95,False,98.0,0.2175681073894274,119.35000000000001,48,47
0,3,100,True,55.0,0.16616130457097383,167.15,50,50
0,3,100,False,59.0,0.20314175316955874,213.45000000000002,50,50
0,4,5,True,53.0,0.0,5.800000000000001,5,0
0,4,5,False,54.0,0.0,5.800000000000001,5,0
0,4,10,True,58.0,0.0,5.800000000000001,10,0
0,4,10,False,54.0,0.0,5.800000000000001,10,0
0,4,15,True,47.0,0.0,5.800000000000001,15,0
0,4,15,False,53.0,0.0,5.800000000000001,15,0
0,4,20,True,52.0,0.0,5.800000000000001,20,0
0,4,20,False,51.0,0.0,5.800000000000001,20,0
0,4,25,True,49.0,0.0,5.800000000000001,25,0
0,4,25,False,97.0,0.07427062193985051,86.95,12,13
0,4,30,True,51.0,0.0,5.800000000000001,30,0
0,4,30,False,98.0,0.11537076742824555,136.3,15,15
0,4,35,True,54.0,0.0,5.800000000000001,35,0
0,4,35,False,98.0,0.14582562879038652,129.4,17,18
0,4,40,True,52.0,0.0,5.800000000000001,40,0
0,4,40,False,97.0,0.13609851755362898,102.05000000000001,20,20
0,4,45,True,64.0,0.0,5.800000000000001,45,0
0,4,45,False,94.0,0.14832068041018862,101.5,22,23
0,4,50,True,54.0,0.0,5.800000000000001,50,0
0,4,50,False,95.0,0.17286074463252774,105.0,25,25
0,4,55,True,56.0,0.0,5.800000000000001,55,0
0,4,55,False,46.0,0.004545961592064758,200.70000000000002,0,55
0,4,60,True,51.0,0.0005901922025014205,52.650000000000006,0,60
0,4,60,False,56.0,0.0020776372013587463,,0,60
0,4,65,True,60.0,0.0003489829389270598,31.75,65,0
0,4,65,False,55.0,0.04745821467668292,57.1,1,64
0,4,70,True,58.0,0.004608598082417545,,30,40
0,4,70,False,80.0,0.18627621300632477,51.300000000000004,70,0
0,4,75,True,59.0,0.0009941578157554435,201.05,75,0
0,4,75,False,53.0,0.04670031087193985,,75,0
0,4,80,True,53.0,0.0005406157342453206,,29,51
0,4,80,False,99.0,0.23559846112460692,104.75,40,40
0,4,85,True,53.0,0.008911597572483956,115.10000000000001,42,43
0,4,85,False,53.0,0.05959892915346852,37.5,84,1
0,4,90,True,56.0,0.005660529865131066,125.15,63,27
0,4,90,False,80.0,0.233918821873731,89.9,45,45
0,4,95,True,56.0,0.013680125265797793,281.5,48,47
0,4,95,False,59.0,0.06742960364398083,104.95,1,94
0,4,100,True,58.0,0.1432580127595502,263.2,64,36
0,4,100,False,45.0,0.2236916552396047,80.9,50,50
0,5,5,True,43.0,0.0,5.800000000000001,5,0
0,5,5,False,53.0,0.0,5.800000000000001,5,0
0,5,10,True,56.0,0.0,5.800000000000001,10,0
0,5,10,False,61.0,0.0,5.800000000000001,10,0
0,5,15,True,53.0,0.0,5.800000000000001,15,0
0,5,15,False,49.0,0.0,5.800000000000001,15,0
0,5,20,True,53.0,0.0,5.800000000000001,20,0
0,5,20,False,58.0,0.0,5.800000000000001,20,0
0,5,25,True,53.0,0.0,5.800000000000001,25,0
0,5,25,False,97.0,0.07994219718145255,97.15,13,12
0,5,30,True,52.0,0.0,5.800000000000001,30,0
0,5,30,False,99.0,0.11055637378012184,130.85,15,15
0,5,35,True,56.0,0.0,5.800000000000001,35,0
0,5,35,False,96.0,0.1178377947804531,68.10000000000001,17,18
0,5,40,True,48.0,0.0,5.800000000000001,40,0
0,5,40,False,97.0,0.16122176969936003,87.80000000000001,20,20
0,5,45,True,54.0,0.0,5.800000000000001,45,0
0,5,45,False,100.0,0.1560298667379795,91.80000000000001,22,23
0,5,50,True,48.0,0.0,5.800000000000001,50,0
0,5,50,False,100.0,0.1797617867914991,60.550000000000004,25,25
0,5,55,True,52.0,2.5238275156141556e-05,29.25,55,0
0,5,55,False,54.0,0.004929486449289605,83.25,0,55
0,5,60,True,51.0,0.0013239507127713452,24.150000000000002,15,45
0,5,60,False,99.0,0.1992191052801801,131.25,30,30
0,5,65,True,55.0,0.0011123257705801088,,2,63
0,5,65,False,48.0,0.09905623166547872,78.75,32,33
0,5,70,True,46.0,0.004341949449084358,222.60000000000002,29,41
0,5,70,False,100.0,0.22461798951379255,108.4,35,35
0,5,75,True,53.0,0.011604887483040937,,38,37
0,5,75,False,63.0,0.13341862461898854,199.15,37,38
0,5,80,True,51.0,0.03926576677656704,,40,40
0,5,80,False,49.0,0.10917038623058209,66.7,0,80
0,5,85,True,65.0,0.008963404052652321,143.55,43,42
0,5,85,False,95.0,0.23224796444126936,47.300000000000004,42,43
0,5,90,True,57.0,0.021129338495536467,147.45000000000002,87,3
0,5,90,False,100.0,0.23525328871377948,97.65,46,44
0,5,95,True,62.0,0.0007922790812250842,102.05000000000001,87,8
0,5,95,False,84.0,0.19863063754518406,208.85000000000002,48,47
0,5,100,True,52.0,0.11641629605864981,130.95000000000002,53,47
0,5,100,False,49.0,0.22136698262466006,230.10000000000002,50,50
0,6,5,True,46.0,0.0,5.800000000000001,5,0
0,6,5,False,56.0,0.0,5.800000000000001,5,0
0,6,10,True,53.0,0.0,5.800000000000001,10,0
0,6,10,False,63.0,0.0,5.800000000000001,10,0
0,6,15,True,51.0,0.0,5.800000000000001,15,0
0,6,15,False,55.0,0.0,5.800000000000001,15,0
0,6,20,True,61.0,0.0,5.800000000000001,20,0
0,6,20,False,52.0,0.0,5.800000000000001,20,0
0,6,25,True,51.0,0.0,5.800000000000001,25,0
0,6,25,False,98.0,0.07734387573770675,135.65,13,12
0,6,30,True,61.0,0.0,5.800000000000001,30,0
0,6,30,False,97.0,0.1149168471740478,113.55000000000001,15,15
0,6,35,True,54.0,0.0,5.800000000000001,35,0
0,6,35,False,99.0,0.12286054078392418,114.4,17,18
0,6,40,True,55.0,0.0,5.800000000000001,40,0
0,6,40,False,99.0,0.14531461747597113,69.2,20,20
0,6,45,True,52.0,2.3360625453001978e-05,56.800000000000004,17,28
0,6,45,False,100.0,0.16257211136374508,105.35000000000001,23,22
0,6,50,True,60.0,0.007258530189329731,6.2,26,24
0,6,50,False,100.0,0.18938296328239274,71.65,25,25
0,6,55,True,52.0,0.014248072230536523,78.60000000000001,27,28
0,6,55,False,49.0,0.008457255100652499,166.55,1,54
0,6,60,True,63.0,0.03611170795133293,26.55,30,30
0,6,60,False,99.0,0.18863583071990417,128.05,30,30
0,6,65,True,56.0,0.027746516397055044,33.9,33,32
0,6,65,False,100.0,0.2456992545397423,130.15,32,33
0,6,70,True,61.0,0.00044185100286071925,38.15,70,0
0,6,70,False,100.0,0.23823683603957072,71.85000000000001,35,35
0,6,75,True,49.0,0.10669844924307854,,38,37
0,6,75,False,98.0,0.20104804058497663,74.15,37,38
0,6,80,True,71.0,0.12958841523974668,,40,40
0,6,80,False,99.0,0.21482992438878337,99.35000000000001,40,40
0,6,85,True,43.0,0.009682055810612824,,1,84
0,6,85,False,99.0,0.21975872221706289,163.70000000000002,44,41
0,6,90,True,47.0,0.002852584926176472,,57,33
0,6,90,False,99.0,0.22394507384982826,163.55,45,45
0,6,95,True,53.0,0.027960675989389516,,48,47
0,6,95,False,100.0,0.23226653691162844,202.75,47,48
0,6,100,True,45.0,0.08614373957959054,244.3,29,71
0,6,100,False,48.0,0.1899393613531906,,50,50
0,7,5,True,53.0,0.0,5.800000000000001,5,0
0,7,5,False,53.0,0.0,5.800000000000001,5,0
0,7,10,True,54.0,0.0,5.800000000000001,10,0
0,7,10,False,57.0,0.0,5.800000000000001,10,0
0,7,15,True,65.0,0.0,5.800000000000001,15,0
0,7,15,False,59.0,0.0,5.800000000000001,15,0
0,7,20,True,56.0,0.0,5.800000000000001,20,0
0,7,20,False,56.0,0.0001806886823058075,97.30000000000001,1,19
0,7,25,True,60.0,0.0,5.800000000000001,25,0
0,7,25,False,98.0,0.08304011174731905,76.55,13,12
0,7,30,True,60.0,0.0,5.800000000000001,30,0
0,7,30,False,98.0,0.12621484264090538,104.95,15,15
0,7,35,True,53.0,0.0,5.800000000000001,35,0
0,7,35,False,100.0,0.13700611733312745,122.30000000000001,17,18
0,7,40,True,50.0,7.810495636043838e-05,83.05000000000001,37,3
0,7,40,False,99.0,0.15407617862500225,52.85,20,20
0,7,45,True,51.0,0.00968154438478169,,22,23
0,7,45,False,100.0,0.1707941655337408,113.10000000000001,22,23
0,7,50,True,56.0,0.0037971454584990604,,25,25
0,7,50,False,100.0,0.18476382636142247,84.65,25,25
0,7,55,True,54.0,0.002262012527797233,50.300000000000004,31,24
0,7,55,False,100.0,0.20887535294072132,169.95000000000002,27,28
0,7,60,True,57.0,0.016950679041371416,,29,31
0,7,60,False,100.0,0.1947496966858884,125.75,30,30
0,7,65,True,52.0,0.031028481142003305,263.85,32,33
0,7,65,False,100.0,0.20871927862075024,133.65,32,33
0,7,70,True,59.0,0.16615793454666697,15.450000000000001,35,35
0,7,70,False,98.0,0.19561417765790184,160.9,35,35
0,7,75,True,81.0,0.15477251332436645,,38,37
0,7,75,False,96.0,0.2025258839687918,86.15,37,38
0,7,80,True,85.0,0.1722287079360228,248.35000000000002,40,40
0,7,80,False,98.0,0.21235708967471356,165.25,40,40
0,7,85,True,57.0,0.15991083879552723,262.7,42,43
0,7,85,False,98.0,0.2207436227459438,149.70000000000002,42,43
0,7,90,True,61.0,0.06989957293063334,55.35,44,46
0,7,90,False,53.0,0.14724443816641417,101.80000000000001,7,83
0,7,95,True,55.0,0.06252772746386047,140.9,47,48
0,7,95,False,100.0,0.2247087236809716,102.25,47,48
0,7,100,True,63.0,0.013679898111192393,,98,2
0,7,100,False,51.0,0.12153462871029401,154.65,50,50
0,8,5,True,49.0,0.0,5.800000000000001,5,0
0,8,5,False,53.0,0.0,5.800000000000001,5,0
0,8,10,True,55.0,0.0,5.800000000000001,10,0
0,8,10,False,50.0,0.0,5.800000000000001,10,0
0,8,15,True,49.0,0.0,5.800000000000001,15,0
0,8,15,False,58.0,0.0,5.800000000000001,15,0
0,8,20,True,60.0,0.0,5.800000000000001,20,0
0,8,20,False,55.0,0.0,5.800000000000001,20,0
0,8,25,True,58.0,0.0,5.800000000000001,25,0
0,8,25,False,99.0,0.07653097863205853,99.75,12,13
0,8,30,True,54.0,0.0,5.800000000000001,30,0
0,8,30,False,100.0,0.1219376670025156,170.60000000000002,15,15
0,8,35,True,56.0,0.0,5.800000000000001,35,0
0,8,35,False,99.0,0.11391638911685444,44.7,18,17
0,8,40,True,56.0,0.0,5.800000000000001,40,0
0,8,40,False,99.0,0.1383660994983511,93.85000000000001,20,20
0,8,45,True,55.0,0.0,5.800000000000001,45,0
0,8,45,False,100.0,0.15035507826103794,61.35,23,22
0,8,50,True,61.0,0.0005183096845375741,10.25,17,33
0,8,50,False,100.0,0.1818584697556465,99.85000000000001,25,25
0,8,55,True,50.0,0.00048546355057445695,207.55,45,10
0,8,55,False,55.0,0.00859799027085263,154.20000000000002,0,55
0,8,60,True,75.0,0.0834067651831572,6.5,30,30
0,8,60,False,96.0,0.17570833498365038,75.4,30,30
0,8,65,True,81.0,0.13324685485207796,,33,32
0,8,65,False,48.0,0.005454580903418022,122.5,0,65
0,8,70,True,90.0,0.15281667521307832,288.6,35,35
0,8,70,False,47.0,0.060939011576297386,71.45,70,0
0,8,75,True,43.0,0.004780077677948316,145.55,2,73
0,8,75,False,98.0,0.2046671786896142,145.35,37,38
0,8,80,True,81.0,0.14634607725042986,264.75,40,40
0,8,80,False,98.0,0.20977792766977427,61.1,40,40
0,8,85,True,54.0,0.01721129336274234,198.75,45,40
0,8,85,False,99.0,0.21718089155662024,153.45000000000002,42,43
0,8,90,True,69.0,0.03838435183677814,177.35000000000002,46,44
0,8,90,False,48.0,0.11119487396762011,74.60000000000001,0,90
0,8,95,True,65.0,0.10318492054191321,200.5,50,45
0,8,95,False,98.0,0.22549709646704683,74.05,50,45
0,8,100,True,42.0,0.01812793378487241,278.25,0,100
0,8,100,False,49.0,0.11008491933795841,,50,50
0,9,5,True,61.0,0.0,5.800000000000001,5,0
0,9,5,False,56.0,0.0,5.800000000000001,5,0
0,9,10,True,56.0,0.0,5.800000000000001,10,0
0,9,10,False,48.0,0.0,5.800000000000001,10,0
0,9,15,True,57.0,0.0,5.800000000000001,15,0
0,9,15,False,48.0,0.0,5.800000000000001,15,0
0,9,20,True,56.0,0.0,5.800000000000001,20,0
0,9,20,False,55.0,0.0,5.800000000000001,20,0
0,9,25,True,53.0,0.0,5.800000000000001,25,0
0,9,25,False,99.0,0.07625349333222721,91.60000000000001,12,13
0,9,30,True,50.0,0.0,5.800000000000001,30,0
0,9,30,False,98.0,0.10441717009429861,54.150000000000006,15,15
0,9,35,True,58.0,0.0,5.800000000000001,35,0
0,9,35,False,99.0,0.11727851014795479,135.8,17,18
0,9,40,True,53.0,0.0,5.800000000000001,40,0
0,9,40,False,100.0,0.1373383276888394,80.5,20,20
0,9,45,True,49.0,0.0,5.800000000000001,45,0
0,9,45,False,100.0,0.16837072014994067,117.05000000000001,22,23
0,9,50,True,57.0,0.001167806773141898,,8,42
0,9,50,False,98.0,0.15800760197659303,57.550000000000004,25,25
0,9,55,True,71.0,0.03468409774926198,28.900000000000002,28,27
0,9,55,False,100.0,0.1849327972796229,84.55000000000001,28,27
0,9,60,True,94.0,0.15588865969874405,,30,30
0,9,60,False,97.0,0.18059155028910676,52.45,30,30
0,9,65,True,81.0,0.14363316999335918,4.7,32,33
0,9,65,False,97.0,0.18424935740088483,50.550000000000004,32,33
0,9,70,True,91.0,0.156157205489776,,35,35
0,9,70,False,50.0,0.0291776304882131,197.05,70,0
0,9,75,True,85.0,0.1505855526321479,300.40000000000003,38,37
0,9,75,False,98.0,0.1945007556955096,102.7,38,37
0,9,80,True,91.0,0.17407505971133322,176.60000000000002,40,40
0,9,80,False,98.0,0.2071566592311895,93.7,40,40
0,9,85,True,87.0,0.15365586792370028,205.8,44,41
0,9,85,False,99.0,0.21276130871177382,149.9,42,43
0,9,90,True,83.0,0.16082987152177172,185.60000000000002,46,44
0,9,90,False,99.0,0.21678027429190522,129.0,45,45
0,9,95,True,71.0,0.13029138354082204,,48,47
0,9,95,False,99.0,0.22619624782844425,109.05000000000001,47,48
0,9,100,True,45.0,0.0031767905289182387,,100,0
0,9,100,False,49.0,0.07847158230460695,150.75,53,47
0,10,5,True,58.0,0.0,5.800000000000001,5,0
0,10,5,False,47.0,0.0,5.800000000000001,5,0
0,10,10,True,53.0,0.0,5.800000000000001,10,0
0,10,10,False,53.0,0.0,5.800000000000001,10,0
0,10,15,True,49.0,0.0,5.800000000000001,15,0
0,10,15,False,58.0,0.0,5.800000000000001,15,0
0,10,20,True,57.0,0.0,5.800000000000001,20,0
0,10,20,False,58.0,0.0,5.800000000000001,20,0
0,10,25,True,54.0,0.0,5.800000000000001,25,0
0,10,25,False,99.0,0.07750470750102349,99.15,12,13
0,10,30,True,53.0,0.0,5.800000000000001,30,0
0,10,30,False,100.0,0.10585310733710192,129.8,15,15
0,10,35,True,57.0,0.0,5.800000000000001,35,0
0,10,35,False,100.0,0.12739679914297286,124.5,17,18
0,10,40,True,51.0,0.0002135291777645951,201.0,28,12
0,10,40,False,100.0,0.1579024845049076,88.7,20,20
0,10,45,True,46.0,1.0301316719519238e-05,,35,10
0,10,45,False,100.0,0.14531160542558563,76.7,22,23
0,10,50,True,52.0,0.0018526927400715277,205.10000000000002,47,3
0,10,50,False,100.0,0.1846212559097359,131.3,25,25
0,10,55,True,78.0,0.11977019171279096,,27,28
0,10,55,False,96.0,0.1711213995041973,101.10000000000001,27,28
0,10,60,True,45.0,0.02486819706033386,42.5,36,24
0,10,60,False,95.0,0.1807876835669109,72.3,30,30
0,10,65,True,67.0,0.1316477112786397,212.9,32,33
0,10,65,False,52.0,0.017220323811401456,84.9,1,64
0,10,70,True,82.0,0.15091804399471476,283.1,35,35
0,10,70,False,97.0,0.19778390943589824,298.0,35,35
0,10,75,True,80.0,0.1544583757747572,177.55,38,37
0,10,75,False,97.0,0.19150611660392985,146.95000000000002,37,38
0,10,80,True,85.0,0.14909777201590263,226.45000000000002,40,40
0,10,80,False,95.0,0.19753705745200476,189.65,40,40
0,10,85,True,84.0,0.16083661791799336,,43,42
0,10,85,False,97.0,0.20891997493536832,96.2,42,43
0,10,90,True,94.0,0.18668932987300516,199.60000000000002,45,45
0,10,90,False,100.0,0.21830684001123324,287.90000000000003,45,45
0,10,95,True,86.0,0.17768337110068086,205.10000000000002,48,47
0,10,95,False,100.0,0.2258247390667989,53.7,48,47
0,10,100,True,52.0,0.0006230664447330311,155.85000000000002,100,0
0,10,100,False,47.0,0.08213249675247794,,54,46
1,0,5,True,57.0,0.0,5.800000000000001,5,0
1,0,5,False,55.0,0.0,5.800000000000001,5,0
1,0,10,True,55.0,0.0,5.800000000000001,10,0
1,0,10,False,47.0,0.0,5.800000000000001,10,0
1,0,15,True,49.0,0.0,5.800000000000001,15,0
1,0,15,False,56.0,0.0,5.800000000000001,15,0
1,0,20,True,49.0,0.0,5.800000000000001,20,0
1,0,20,False,48.0,0.0,5.800000000000001,20,0
1,0,25,True,54.0,0.0,5.800000000000001,25,0
1,0,25,False,98.0,0.07844726844024467,134.05,13,12
1,0,30,True,61.0,0.0,5.800000000000001,30,0
1,0,30,False,98.0,0.1093227327381384,112.05000000000001,15,15
1,0,35,True,58.0,0.0,5.800000000000001,35,0
1,0,35,False,98.0,0.11987484336469706,68.10000000000001,17,18
1,0,40,True,51.0,0.0,5.800000000000001,40,0
1,0,40,False,97.0,0.1425251467284548,80.25,20,20
1,0,45,True,51.0,0.0,5.800000000000001,45,0
1,0,45,False,96.0,0.15059310289493572,142.05,23,22
1,0,50,True,53.0,0.0,5.800000000000001,50,0
1,0,50,False,97.0,0.172652456617323,146.35,25,25
1,0,55,True,46.0,0.012504804020740666,186.05,1,54
1,0,55,False,39.0,0.2199108269520209,169.0,27,28
1,0,60,True,64.0,0.0033575461599816485,196.4,30,30
1,0,60,False,98.0,0.2124356239029107,124.85000000000001,30,30
1,0,65,True,49.0,0.0011985231524665155,119.60000000000001,33,32
1,0,65,False,98.0,0.207840557847991,,33,32
1,0,70,True,52.0,0.0012944442762525927,158.20000000000002,35,35
1,0,70,False,98.0,0.20252356894979312,143.5,35,35
1,0,75,True,59.0,0.0008786925463301607,126.80000000000001,32,43
1,0,75,False,50.0,0.003466865256447049,165.65,0,75
1,0,80,True,51.0,0.010756962393118,,80,0
1,0,80,False,100.0,0.25285037949563555,113.80000000000001,43,37
1,0,85,True,60.0,9.637237222752958e-05,38.15,25,60
1,0,85,False,98.0,0.2326081342372318,168.70000000000002,42,43
1,0,90,True,48.0,6.205769587363036e-05,78.95,54,36
1,0,90,False,58.0,0.06386379252392314,59.2,90,0
1,0,95,True,64.0,0.002525721693762109,101.9,71,24
1,0,95,False,97.0,0.2273852533803821,26.200000000000003,47,48
1,0,100,True,48.0,0.0002461516074070445,132.15,57,43
1,0,100,False,98.0,0.2217190334498455,132.95000000000002,50,50
1,1,5,True,57.0,0.0,5.800000000000001,5,0
1,1,5,False,52.0,0.0,5.800000000000001,5,0
1,1,10,True,49.0,0.0,5.800000000000001,10,0
1,1,10,False,52.0,0.0,5.800000000000001,10,0
1,1,15,True,63.0,0.0,5.800000000000001,15,0
1,1,15,False,55.0,0.0,5.800000000000001,15,0
1,1,20,True,50.0,0.0,5.800000000000001,20,0
1,1,20,False,60.0,0.0,5.800000000000001,20,0
1,1,25,True,60.0,0.0,5.800000000000001,25,0
1,1,25,False,95.0,0.07739689029357048,94.45,13,12
1,1,30,True,53.0,0.0,5.800000000000001,30,0
1,1,30,False,98.0,0.10707431319956845,104.55000000000001,15,15
1,1,35,True,63.0,0.0,5.800000000000001,35,0
1,1,35,False,96.0,0.11848052485426475,138.05,18,17
1,1,40,True,58.0,0.0,5.800000000000001,40,0
1,1,40,False,97.0,0.14885770799133302,75.0,20,20
1,1,45,True,50.0,0.0,5.800000000000001,45,0
1,1,45,False,57.0,0.1546874647996573,70.25,22,23
1,1,50,True,53.0,0.0,5.800000000000001,50,0
1,1,50,False,44.0,0.16307008492154443,71.2,30,20
1,1,55,True,53.0,0.0,5.800000000000001,55,0
1,1,55,False,43.0,0.1683968695728586,99.15,33,22
1,1,60,True,56.0,0.0,5.800000000000001,60,0
1,1,60,False,43.0,0.15425443552449683,103.2,38,22
1,1,65,True,57.0,0.0,5.800000000000001,65,0
1,1,65,False,51.0,0.15624383866859923,99.0,42,23
1,1,70,True,49.0,0.0,5.800000000000001,70,0
1,1,70,False,50.0,0.16991872310841177,136.25,40,30
1,1,75,True,61.0,0.0,5.800000000000001,75,0
1,1,75,False,49.0,0.1737566138164207,142.65,44,31
1,1,80,True,52.0,0.0,5.800000000000001,80,0
1,1,80,False,53.0,0.1852230978023267,73.2,46,34
1,1,85,True,58.0,0.0,5.800000000000001,85,0
1,1,85,False,56.0,0.1828870027123372,114.10000000000001,45,40
1,1,90,True,48.0,0.0,5.800000000000001,90,0
1,1,90,False,51.0,0.19764215073243116,143.65,45,45
1,1,95,True,49.0,0.0,5.800000000000001,95,0
1,1,95,False,45.0,0.20095847796663924,157.10000000000002,48,47
1,1,100,True,57.0,0.0,5.800000000000001,100,0
1,1,100,False,42.0,0.2098986557845679,76.10000000000001,50,50
1,2,5,True,58.0,0.0,5.800000000000001,5,0
1,2,5,False,55.0,0.0,5.800000000000001,5,0
1,2,10,True,45.0,0.0,5.800000000000001,10,0
1,2,10,False,61.0,0.0,5.800000000000001,10,0
1,2,15,True,56.0,0.0,5.800000000000001,15,0
1,2,15,False,56.0,0.0,5.800000000000001,15,0
1,2,20,True,53.0,0.0,5.800000000000001,20,0
1,2,20,False,60.0,0.0,5.800000000000001,20,0
1,2,25,True,61.0,0.0,5.800000000000001,25,0
1,2,25,False,97.0,0.07580401455533692,226.85000000000002,13,12
1,2,30,True,66.0,0.0,5.800000000000001,30,0
1,2,30,False,97.0,0.10885118538662855,203.5,15,15
1,2,35,True,55.0,0.0,5.800000000000001,35,0
1,2,35,False,98.0,0.1287510438844293,55.800000000000004,18,17
1,2,40,True,54.0,0.0021750032125111645,201.70000000000002,20,20
1,2,40,False,99.0,0.15900944871589806,99.0,20,20
1,2,45,True,55.0,0.0017926749883835425,,23,22
1,2,45,False,100.0,0.16559176712042467,90.7,23,22
1,2,50,True,52.0,0.0,5.800000000000001,50,0
1,2,50,False,100.0,0.18208063417789014,203.95000000000002,25,25
1,2,55,True,53.0,0.0,5.800000000000001,55,0
1,2,55,False,100.0,0.18163493006226417,96.60000000000001,28,27
1,2,60,True,47.0,0.0,5.800000000000001,60,0
1,2,60,False,98.0,0.1872523990924375,99.35000000000001,30,30
1,2,65,True,56.0,0.0,5.800000000000001,65,0
1,2,65,False,100.0,0.18804681324450803,124.0,33,32
1,2,70,True,63.0,0.0,5.800000000000001,70,0
1,2,70,False,100.0,0.19641851401423457,100.65,35,35
1,2,75,True,51.0,0.0,5.800000000000001,75,0
1,2,75,False,100.0,0.19788779792059047,132.1,38,37
1,2,80,True,47.0,0.0,5.800000000000001,80,0
1,2,80,False,100.0,0.2043972199481832,55.5,40,40
1,2,85,True,55.0,0.0,5.800000000000001,85,0
1,2,85,False,100.0,0.20415340545497201,83.45,43,42
1,2,90,True,54.0,0.0,5.800000000000001,90,0
1,2,90,False,100.0,0.21196122841814924,134.5,45,45
1,2,95,True,46.0,0.0,5.800000000000001,95,0
1,2,95,False,100.0,0.21481576949499492,112.10000000000001,48,47
1,2,100,True,53.0,0.0,5.800000000000001,100,0
1,2,100,False,94.0,0.2168217805439798,85.75,50,50
1,3,5,True,61.0,0.0,5.800000000000001,5,0
1,3,5,False,56.0,0.0,5.800000000000001,5,0
1,3,10,True,53.0,0.0,5.800000000000001,10,0
1,3,10,False,51.0,0.0,5.800000000000001,10,0
1,3,15,True,57.0,0.0,5.800000000000001,15,0
1,3,15,False,60.0,0.0,5.800000000000001,15,0
1,3,20,True,57.0,0.0,5.800000000000001,20,0
1,3,20,False,49.0,0.0,5.800000000000001,20,0
1,3,25,True,56.0,0.0,5.800000000000001,25,0
1,3,25,False,98.0,0.07620879762273165,112.60000000000001,13,12
1,3,30,True,63.0,0.0,5.800000000000001,30,0
1,3,30,False,97.0,0.10456437123071521,168.05,15,15
1,3,35,True,45.0,0.0005974966848511364,134.65,18,17
1,3,35,False,97.0,0.1258044862422118,145.5,18,17
1,3,40,True,49.0,0.00159353129201151,164.95000000000002,20,20
1,3,40,False,98.0,0.14250088151929008,35.300000000000004,20,20
1,3,45,True,51.0,0.0006101413792482231,127.4,44,1
1,3,45,False,98.0,0.1607070859255062,75.05,23,22
1,3,50,True,65.0,0.01227130660497173,143.5,25,25
1,3,50,False,99.0,0.1806817302307448,154.4,25,25
1,3,55,True,59.0,0.01622717426227605,211.4,28,27
1,3,55,False,49.0,0.04900037457251406,194.4,28,27
1,3,60,True,53.0,0.06340872858308752,65.7,30,30
1,3,60,False,100.0,0.21849296681283958,94.85000000000001,30,30
1,3,65,True,49.0,0.06764719744718974,141.65,32,33
1,3,65,False,53.0,0.004701226180495413,98.05000000000001,0,65
1,3,70,True,49.0,0.03179140865656538,,35,35
1,3,70,False,58.0,0.0017440914935841093,245.8,0,70
1,3,75,True,54.0,0.15107751683334747,230.9,38,37
1,3,75,False,100.0,0.239656795977796,124.80000000000001,37,38
1,3,80,True,57.0,0.06910178457229676,199.8,40,40
1,3,80,False,79.0,0.15871673149599583,76.05,0,80
1,3,85,True,62.0,0.05118289768947437,263.75,43,42
1,3,85,False,92.0,0.20497546803424813,,42,43
1,3,90,True,56.0,0.07468128477988474,35.550000000000004,55,35
1,3,90,False,74.0,0.19328487575672346,110.80000000000001,45,45
1,3,95,True,58.0,0.04601361480434433,179.45000000000002,47,48
1,3,95,False,95.0,0.21583350375013236,215.4,48,47
1,3,100,True,62.0,0.1671409784830375,110.55000000000001,50,50
1,3,100,False,61.0,0.17998289096820294,,50,50
1,4,5,True,58.0,0.0,5.800000000000001,5,0
1,4,5,False,56.0,0.0,5.800000000000001,5,0
1,4,10,True,53.0,0.0,5.800000000000001,10,0
1,4,10,False,51.0,0.0,5.800000000000001,10,0
1,4,15,True,46.0,0.0,5.800000000000001,15,0
1,4,15,False,51.0,0.0,5.800000000000001,15,0
1,4,20,True,44.0,0.0,5.800000000000001,20,0
1,4,20,False,55.0,0.0,5.800000000000001,20,0
1,4,25,True,50.0,0.0,5.800000000000001,25,0
1,4,25,False,96.0,0.0747746218058268,138.15,12,13
1,4,30,True,53.0,0.0,5.800000000000001,30,0
1,4,30,False,98.0,0.11229519625812429,164.95000000000002,15,15
1,4,35,True,52.0,0.0,5.800000000000001,35,0
1,4,35,False,97.0,0.11543056935536876,138.95000000000002,17,18
1,4,40,True,60.0,0.0,5.800000000000001,40,0
1,4,40,False,96.0,0.1446737742153734,53.150000000000006,20,20
1,4,45,True,46.0,0.0,5.800000000000001,45,0
1,4,45,False,97.0,0.1471569805578123,87.05000000000001,22,23
1,4,50,True,56.0,0.0,5.800000000000001,50,0
1,4,50,False,96.0,0.16338756089846462,99.7,25,25
1,4,55,True,64.0,0.0,5.800000000000001,55,0
1,4,55,False,99.0,0.21578842695674536,57.25,27,28
1,4,60,True,51.0,0.0,5.800000000000001,60,0
1,4,60,False,94.0,0.21942767795107415,171.10000000000002,31,29
1,4,65,True,52.0,0.00033547787171143875,49.2,57,8
1,4,65,False,57.0,0.005173512020874517,67.55,1,64
1,4,70,True,49.0,0.0008609810393705023,,70,0
1,4,70,False,94.0,0.20704670551731114,106.05000000000001,47,23
1,4,75,True,44.0,0.009258418010825576,193.75,37,38
1,4,75,False,100.0,0.21414058721156237,104.9,37,38
1,4,80,True,52.0,0.001008943192284133,,80,0
1,4,80,False,99.0,0.21843655508144702,183.25,40,40
1,4,85,True,54.0,0.0037700940858565552,269.45,21,64
1,4,85,False,100.0,0.2325499043481062,51.5,42,43
1,4,90,True,62.0,0.0038174247979359064,172.60000000000002,0,90
1,4,90,False,57.0,0.0006630859006380007,,0,90
1,4,95,True,63.0,0.01693861153107909,260.65000000000003,70,25
1,4,95,False,95.0,0.21580806704877528,145.25,47,48
1,4,100,True,45.0,0.16708423537761807,,50,50
1,4,100,False,42.0,0.2235551593441299,,50,50
1,5,5,True,59.0,0.0,5.800000000000001,5,0
1,5,5,False,54.0,0.0,5.800000000000001,5,0
1,5,10,True,59.0,0.0,5.800000000000001,10,0
1,5,10,False,61.0,0.0,5.800000000000001,10,0
1,5,15,True,63.0,0.0,5.800000000000001,15,0
1,5,15,False,60.0,0.0,5.800000000000001,15,0
1,5,20,True,55.0,0.0,5.800000000000001,20,0
1,5,20,False,54.0,0.0,5.800000000000001,20,0
1,5,25,True,59.0,0.0,5.800000000000001,25,0
1,5,25,False,98.0,0.07718414806387058,73.15,12,13
1,5,30,True,50.0,0.0,5.800000000000001,30,0
1,5,30,False,98.0,0.1103211403223388,90.0,15,15
1,5,35,True,52.0,0.0,5.800000000000001,35,0
1,5,35,False,100.0,0.13520952994198876,90.25,17,18
1,5,40,True,53.0,0.0,5.800000000000001,40,0
1,5,40,False,98.0,0.1532933017148911,179.45000000000002,20,20
1,5,45,True,54.0,0.0,5.800000000000001,45,0
1,5,45,False,99.0,0.1620438874580036,15.3,22,23
1,5,50,True,56.0,6.163937826823116e-05,51.5,14,36
1,5,50,False,100.0,0.2171084423274752,66.10000000000001,25,25
1,5,55,True,52.0,0.000391852290710045,15.75,2,53
1,5,55,False,98.0,0.19340079276719913,77.10000000000001,27,28
1,5,60,True,49.0,0.0015602471013569307,35.1,10,50
1,5,60,False,49.0,0.05600804681952603,89.65,60,0
1,5,65,True,43.0,0.00525161657643417,50.1,33,32
1,5,65,False,50.0,0.039674371638256614,61.6,0,65
1,5,70,True,70.0,0.018702471616432598,57.150000000000006,35,35
1,5,70,False,83.0,0.23597113272827266,134.4,35,35
1,5,75,True,53.0,0.01893045482059416,20.400000000000002,39,36
1,5,75,False,100.0,0.21044599339341863,137.95000000000002,37,38
1,5,80,True,58.0,0.005751962418266861,,0,80
1,5,80,False,100.0,0.2336976630211682,162.60000000000002,40,40
1,5,85,True,58.0,0.0007025228178911049,105.80000000000001,0,85
1,5,85,False,100.0,0.2194213354839682,127.5,42,43
1,5,90,True,47.0,0.01752935775150693,135.55,45,45
1,5,90,False,80.0,0.16693280295920246,25.200000000000003,88,2
1,5,95,True,57.0,0.0006084084246039039,195.5,32,63
1,5,95,False,100.0,0.2217997455758865,137.55,47,48
1,5,100,True,53.0,0.12501177010788347,121.65,50,50
1,5,100,False,47.0,0.22452852434342985,231.0,50,50
1,6,5,True,54.0,0.0,5.800000000000001,5,0
1,6,5,False,61.0,0.0,5.800000000000001,5,0
1,6,10,True,59.0,0.0,5.800000000000001,10,0
1,6,10,False,52.0,0.0,5.800000000000001,10,0
1,6,15,True,47.0,0.0,5.800000000000001,15,0
1,6,15,False,58.0,0.0,5.800000000000001,15,0
1,6,20,True,58.0,0.0,5.800000000000001,20,0
1,6,20,False,57.0,0.0,5.800000000000001,20,0
1,6,25,True,52.0,0.0,5.800000000000001,25,0
1,6,25,False,98.0,0.0750040267906351,67.95,12,13
1,6,30,True,51.0,0.0,5.800000000000001,30,0
1,6,30,False,97.0,0.10842738334550135,92.15,15,15
1,6,35,True,54.0,0.0,5.800000000000001,35,0
1,6,35,False,98.0,0.12122580317703449,107.45,17,18
1,6,40,True,57.0,0.0,5.800000000000001,40,0
1,6,40,False,99.0,0.14688958071995442,136.5,20,20
1,6,45,True,44.0,8.48523990331812e-05,54.25,35,10
1,6,45,False,100.0,0.16066435297490675,236.20000000000002,22,23
1,6,50,True,50.0,0.0036223701988522023,,26,24
1,6,50,False,95.0,0.24025127537831062,59.7,25,25
1,6,55,True,52.0,0.002306745176145694,58.35,52,3
1,6,55,False,54.0,0.008072283264379573,159.15,1,54
1,6,60,True,49.0,4.502991113295881e-05,138.3,0,60
1,6,60,False,100.0,0.20146188265136317,165.20000000000002,30,30
1,6,65,True,62.0,0.022572160125267055,20.400000000000002,33,32
1,6,65,False,100.0,0.24670120845981652,,32,33
1,6,70,True,55.0,0.0005928345235027414,134.85,0,70
1,6,70,False,41.0,0.11759145804446175,47.25,38,32
1,6,75,True,49.0,0.008883731927320946,,32,43
1,6,75,False,60.0,0.09675728420053366,104.85000000000001,75,0
1,6,80,True,74.0,0.11368219447362791,61.25,40,40
1,6,80,False,100.0,0.23177975798168649,174.60000000000002,40,40
1,6,85,True,60.0,0.022089039165277897,,43,42
1,6,85,False,99.0,0.2182131314702941,,42,43
1,6,90,True,49.0,0.02271287589674517,,46,44
1,6,90,False,99.0,0.2217113327511924,208.5,46,44
1,6,95,True,52.0,0.0017334354520424703,,16,79
1,6,95,False,98.0,0.218277397205818,77.2,47,48
1,6,100,True,44.0,0.1159113588472096,,39,61
1,6,100,False,46.0,0.16086331393563175,12.600000000000001,50,50
1,7,5,True,51.0,0.0,5.800000000000001,5,0
1,7,5,False,55.0,0.0,5.800000000000001,5,0
1,7,10,True,55.0,0.0,5.800000000000001,10,0
1,7,10,False,61.0,0.0,5.800000000000001,10,0
1,7,15,True,38.0,0.0,5.800000000000001,15,0
1,7,15,False,60.0,0.0,5.800000000000001,15,0
1,7,20,True,47.0,0.0,5.800000000000001,20,0
1,7,20,False,57.0,0.0,5.800000000000001,20,0
1,7,25,True,47.0,0.0,5.800000000000001,25,0
1,7,25,False,97.0,0.07710424983564272,97.4,12,13
1,7,30,True,52.0,0.0,5.800000000000001,30,0
1,7,30,False,98.0,0.11595036360734068,86.9,15,15
1,7,35,True,47.0,0.0,5.800000000000001,35,0
1,7,35,False,99.0,0.12553550066436547,134.70000000000002,17,18
1,7,40,True,49.0,4.677252207025179e-05,84.85000000000001,28,12
1,7,40,False,98.0,0.15309307982592724,65.8,20,20
1,7,45,True,57.0,0.005643100222932482,29.05,22,23
1,7,45,False,88.0,0.21498665965163932,114.55000000000001,22,23
1,7,50,True,49.0,0.00020732256549863066,,10,40
1,7,50,False,51.0,0.20291930420106735,81.0,24,26
1,7,55,True,53.0,0.03827900678066382,19.1,29,26
1,7,55,False,55.0,0.03402454559211305,59.300000000000004,1,54
1,7,60,True,49.0,0.06016320989465254,,30,30
1,7,60,False,48.0,0.003461124531748489,133.75,0,60
1,7,65,True,49.0,0.0008021062255216833,201.15,21,44
1,7,65,False,99.0,0.19080485489965712,200.05,33,32
1,7,70,True,62.0,0.00018325388896482087,127.75,4,66
1,7,70,False,98.0,0.18690600211542505,48.6,35,35
1,7,75,True,78.0,0.1361133684180412,349.95000000000005,37,38
1,7,75,False,52.0,0.055500926358461454,71.45,75,0
1,7,80,True,87.0,0.14382243812888373,,41,39
1,7,80,False,55.0,0.03636791397033122,189.5,80,0
1,7,85,True,78.0,0.15439731773042575,236.65,43,42
1,7,85,False,100.0,0.22305393169495683,163.9,42,43
1,7,90,True,63.0,0.13051424855887425,110.75,45,45
1,7,90,False,96.0,0.23377296027043168,137.75,51,39
1,7,95,True,62.0,0.17253053501330912,,47,48
1,7,95,False,57.0,0.12274798759787112,116.75,78,17
1,7,100,True,55.0,0.0172437395540141,,97,3
1,7,100,False,51.0,0.11707761506855706,,50,50
1,8,5,True,60.0,0.0,5.800000000000001,5,0
1,8,5,False,50.0,0.0,5.800000000000001,5,0
1,8,10,True,60.0,0.0,5.800000000000001,10,0
1,8,10,False,49.0,0.0,5.800000000000001,10,0
1,8,15,True,58.0,0.0,5.800000000000001,15,0
1,8,15,False,50.0,0.0,5.800000000000001,15,0
1,8,20,True,53.0,0.0,5.800000000000001,20,0
1,8,20,False,98.0,0.054251787078038904,124.10000000000001,19,1
1,8,25,True,53.0,0.0,5.800000000000001,25,0
1,8,25,False,100.0,0.07736461892182057,222.5,12,13
1,8,30,True,55.0,0.0,5.800000000000001,30,0
1,8,30,False,99.0,0.10689053913226246,135.5,15,15
1,8,35,True,50.0,0.0,5.800000000000001,35,0
1,8,35,False,99.0,0.13774794982267594,76.85000000000001,17,18
1,8,40,True,60.0,0.0,5.800000000000001,40,0
1,8,40,False,98.0,0.1353689721392587,67.75,20,20
1,8,45,True,44.0,0.0,5.800000000000001,45,0
1,8,45,False,100.0,0.156155233968262,103.05000000000001,22,23
1,8,50,True,54.0,0.0009007182579229662,123.30000000000001,25,25
1,8,50,False,100.0,0.17075714042326184,98.60000000000001,25,25
1,8,55,True,61.0,0.0018070227860524132,32.6,27,28
1,8,55,False,100.0,0.2116812442253476,79.10000000000001,27,28
1,8,60,True,73.0,0.07221442543045989,190.85000000000002,30,30
1,8,60,False,98.0,0.17340612905945424,84.15,30,30
1,8,65,True,77.0,0.13022925927481907,299.40000000000003,33,32
1,8,65,False,100.0,0.19284826124374368,245.55,32,33
1,8,70,True,80.0,0.14847214963496777,,35,35
1,8,70,False,49.0,0.054684390477226674,101.9,70,0
1,8,75,True,92.0,0.15150212527263454,293.35,39,36
1,8,75,False,100.0,0.21825544506720176,168.15,37,38
1,8,80,True,82.0,0.14580211783359454,,40,40
1,8,80,False,99.0,0.20726642593355507,165.15,40,40
1,8,85,True,80.0,0.13604464987361625,209.75,45,40
1,8,85,False,98.0,0.2149507806871805,165.3,42,43
1,8,90,True,71.0,0.1210826031571734,1.7000000000000002,46,44
1,8,90,False,100.0,0.2455970986833804,215.3,45,45
1,8,95,True,71.0,0.12943536841166411,,48,47
1,8,95,False,91.0,0.22540138484723607,,52,43
1,8,100,True,52.0,0.02107206004459234,,99,1
1,8,100,False,48.0,0.07769531059001508,151.35,49,51
1,9,5,True,51.0,0.0,5.800000000000001,5,0
1,9,5,False,52.0,0.0,5.800000000000001,5,0
1,9,10,True,60.0,0.0,5.800000000000001,10,0
1,9,10,False,49.0,0.0,5.800000000000001,10,0
1,9,15,True,61.0,0.0,5.800000000000001,15,0
1,9,15,False,47.0,0.0,5.800000000000001,15,0
1,9,20,True,57.0,0.0,5.800000000000001,20,0
1,9,20,False,50.0,0.0,5.800000000000001,20,0
1,9,25,True,48.0,0.0,5.800000000000001,25,0
1,9,25,False,99.0,0.07516124174614743,62.7,13,12
1,9,30,True,52.0,0.0,5.800000000000001,30,0
1,9,30,False,99.0,0.10218455044076472,214.35000000000002,15,15
1,9,35,True,48.0,0.0,5.800000000000001,35,0
1,9,35,False,100.0,0.12014178250286231,38.75,17,18
1,9,40,True,63.0,4.110616079477585e-05,,10,30
1,9,40,False,100.0,0.15788090556950743,161.95000000000002,20,20
1,9,45,True,52.0,1.4385334423162049e-05,,29,16
1,9,45,False,100.0,0.1487868136934528,100.25,23,22
1,9,50,True,51.0,0.002336138383399639,,30,20
1,9,50,False,99.0,0.16027610368315687,,25,25
1,9,55,True,71.0,0.043032268777284124,132.05,27,28
1,9,55,False,50.0,0.052009394508930044,149.65,55,0
1,9,60,True,51.0,0.12614334693599072,,30,30
1,9,60,False,98.0,0.17984517138951503,49.95,30,30
1,9,65,True,87.0,0.1464621673090498,,33,32
1,9,65,False,56.0,0.01216576350013591,90.80000000000001,1,64
1,9,70,True,91.0,0.15034414150514935,,35,35
1,9,70,False,100.0,0.22337143750561916,136.95000000000002,35,35
1,9,75,True,85.0,0.14153317232141555,205.60000000000002,39,36
1,9,75,False,97.0,0.19918937159658753,146.3,38,37
1,9,80,True,55.0,0.018291922896430977,221.3,0,80
1,9,80,False,99.0,0.21958272486842612,99.45,40,40
1,9,85,True,86.0,0.1634154153652153,196.60000000000002,43,42
1,9,85,False,97.0,0.21446846006684367,112.25,42,43
1,9,90,True,49.0,0.011982945979980281,,4,86
1,9,90,False,99.0,0.21199982783210947,100.55000000000001,45,45
1,9,95,True,76.0,0.16811029008796213,140.25,47,48
1,9,95,False,98.0,0.22065735747055232,177.20000000000002,49,46
1,9,100,True,45.0,0.07095694951868212,,34,66
1,9,100,False,49.0,0.12103240533149384,82.75,50,50
1,10,5,True,44.0,0.0,5.800000000000001,5,0
1,10,5,False,61.0,0.0,5.800000000000001,5,0
1,10,10,True,45.0,0.0,5.800000000000001,10,0
1,10,10,False,55.0,0.0,5.800000000000001,10,0
1,10,15,True,54.0,0.0,5.800000000000001,15,0
1,10,15,False,48.0,0.0,5.800000000000001,15,0
1,10,20,True,54.0,0.0,5.800000000000001,20,0
1,10,20,False,56.0,0.0,5.800000000000001,20,0
1,10,25,True,51.0,0.0,5.800000000000001,25,0
1,10,25,False,99.0,0.07647655832511208,111.5,12,13
1,10,30,True,56.0,0.0,5.800000000000001,30,0
1,10,30,False,98.0,0.10632857665174758,102.60000000000001,15,15
1,10,35,True,43.0,0.0,5.800000000000001,35,0
1,10,35,False,100.0,0.12255837245577689,98.25,17,18
1,10,40,True,56.0,0.0,5.800000000000001,40,0
1,10,40,False,100.0,0.16202189889666102,80.5,20,20
1,10,45,True,49.0,0.0005726651952811758,161.65,6,39
1,10,45,False,100.0,0.1777777055564831,100.55000000000001,22,23
1,10,50,True,58.0,0.01529361975641946,191.55,25,25
1,10,50,False,100.0,0.18120966572258412,80.60000000000001,25,25
1,10,55,True,79.0,0.1273966497864636,92.60000000000001,28,27
1,10,55,False,50.0,0.03291320040437574,63.050000000000004,35,20
1,10,60,True,81.0,0.13737724675175025,242.70000000000002,30,30
1,10,60,False,97.0,0.17950979152993848,132.20000000000002,30,30
1,10,65,True,96.0,0.15730403578144656,248.25,33,32
1,10,65,False,99.0,0.18481757462333392,137.5,32,33
1,10,70,True,92.0,0.1594332349070788,48.650000000000006,35,35
1,10,70,False,44.0,0.06261594360007638,,48,22
1,10,75,True,88.0,0.1609029754645362,,38,37
1,10,75,False,94.0,0.19305700151380298,266.2,37,38
1,10,80,True,86.0,0.16200240054301795,189.20000000000002,40,40
1,10,80,False,97.0,0.1994047842579544,,40,40
1,10,85,True,94.0,0.16384312863236722,179.8,43,42
1,10,85,False,97.0,0.21040897420494534,147.6,42,43
1,10,90,True,91.0,0.16487910627239943,132.4,46,44
1,10,90,False,98.0,0.21264620773998244,118.75,45,45
1,10,95,True,65.0,0.16159106334734727,,48,47
1,10,95,False,100.0,0.2220581431049514,68.2,47,48
1,10,100,True,51.0,0.006721576191241602,117.65,100,0
1,10,100,False,46.0,0.11079450402799616,,50,50
2,0,5,True,53.0,0.0,5.800000000000001,5,0
2,0,5,False,55.0,0.0,5.800000000000001,5,0
2,0,10,True,49.0,0.0,5.800000000000001,10,0
2,0,10,False,54.0,0.0,5.800000000000001,10,0
2,0,15,True,51.0,0.0,5.800000000000001,15,0
2,0,15,False,61.0,0.0,5.800000000000001,15,0
2,0,20,True,57.0,0.0,5.800000000000001,20,0
2,0,20,False,59.0,0.0,5.800000000000001,20,0
2,0,25,True,65.0,0.0,5.800000000000001,25,0
2,0,25,False,96.0,0.07739353080320693,97.5,13,12
2,0,30,True,52.0,0.0,5.800000000000001,30,0
2,0,30,False,98.0,0.10955480310678889,49.6,15,15
2,0,35,True,55.0,0.0,5.800000000000001,35,0
2,0,35,False,98.0,0.12312414455395382,126.15,17,18
2,0,40,True,58.0,0.0,5.800000000000001,40,0
2,0,40,False,98.0,0.1447539749624379,29.8,20,20
2,0,45,True,61.0,0.0,5.800000000000001,45,0
2,0,45,False,96.0,0.15195110471635598,65.7,23,22
2,0,50,True,56.0,0.0,5.800000000000001,50,0
2,0,50,False,98.0,0.17400718619927635,136.9,25,25
2,0,55,True,56.0,0.19638878328941717,217.70000000000002,28,27
2,0,55,False,100.0,0.27425181672525717,97.7,27,28
2,0,60,True,58.0,0.0035115212393976507,196.35000000000002,30,30
2,0,60,False,50.0,0.19710594011540605,53.5,34,26
2,0,65,True,55.0,0.0003563362402373523,133.8,1,64
2,0,65,False,98.0,0.20416223914958653,104.05000000000001,32,33
2,0,70,True,47.0,0.0016405603702453432,160.60000000000002,36,34
2,0,70,False,99.0,0.22735422562059554,125.65,35,35
2,0,75,True,51.0,0.06207581846504229,250.85000000000002,38,37
2,0,75,False,55.0,0.0049985833558060366,153.5,1,74
2,0,80,True,50.0,0.002565110820151081,115.9,40,40
2,0,80,False,98.0,0.2111080683314542,128.35,40,40
2,0,85,True,62.0,0.010392953591864772,131.65,43,42
2,0,85,False,99.0,0.23744525522597607,141.15,42,43
2,0,90,True,63.0,0.002007251380916404,128.20000000000002,75,15
2,0,90,False,99.0,0.20758143405331464,300.40000000000003,45,45
2,0,95,True,50.0,0.00029247128402854107,127.15,88,7
2,0,95,False,99.0,0.21470421677657237,211.35000000000002,47,48
2,0,100,True,53.0,0.005031112974063591,57.900000000000006,90,10
2,0,100,False,98.0,0.21435509324580485,98.65,50,50
2,1,5,True,54.0,0.0,5.800000000000001,5,0
2,1,5,False,49.0,0.0,5.800000000000001,5,0
2,1,10,True,49.0,0.0,5.800000000000001,10,0
2,1,10,False,53.0,0.0,5.800000000000001,10,0
2,1,15,True,53.0,0.0,5.800000000000001,15,0
2,1,15,False,49.0,0.0,5.800000000000001,15,0
2,1,20,True,53.0,0.0,5.800000000000001,20,0
2,1,20,False,56.0,0.0,5.800000000000001,20,0
2,1,25,True,60.0,0.0,5.800000000000001,25,0
2,1,25,False,97.0,0.07755214831917115,68.60000000000001,13,12
2,1,30,True,56.0,0.0,5.800000000000001,30,0
2,1,30,False,98.0,0.10502680467009488,189.60000000000002,15,15
2,1,35,True,51.0,0.0,5.800000000000001,35,0
2,1,35,False,97.0,0.12085324093130706,135.25,17,18
2,1,40,True,55.0,0.0,5.800000000000001,40,0
2,1,40,False,97.0,0.14436555946574514,88.0,20,20
2,1,45,True,52.0,0.0,5.800000000000001,45,0
2,1,45,False,42.0,0.15664188623840725,198.95000000000002,22,23
2,1,50,True,52.0,0.0,5.800000000000001,50,0
2,1,50,False,39.0,0.16264544609333562,94.80000000000001,29,21
2,1,55,True,56.0,0.0,5.800000000000001,55,0
2,1,55,False,39.0,0.17320311625579757,98.5,33,22
2,1,60,True,55.0,0.0,5.800000000000001,60,0
2,1,60,False,48.0,0.16183624199089486,95.75,35,25
2,1,65,True,57.0,0.0,5.800000000000001,65,0
2,1,65,False,46.0,0.16089892507288897,134.65,42,23
2,1,70,True,55.0,0.0,5.800000000000001,70,0
2,1,70,False,51.0,0.16111932624131703,158.20000000000002,42,28
2,1,75,True,55.0,0.0,5.800000000000001,75,0
2,1,75,False,46.0,0.18310457179269218,79.15,44,31
2,1,80,True,64.0,0.0,5.800000000000001,80,0
2,1,80,False,47.0,0.18382938839657742,86.35000000000001,44,36
2,1,85,True,57.0,0.0,5.800000000000001,85,0
2,1,85,False,47.0,0.19388575831528165,130.45000000000002,49,36
2,1,90,True,57.0,0.0,5.800000000000001,90,0
2,1,90,False,50.0,0.2003826348249566,93.60000000000001,45,45
2,1,95,True,55.0,0.0,5.800000000000001,95,0
2,1,95,False,38.0,0.2052274629071628,122.0,47,48
2,1,100,True,57.0,0.0,5.800000000000001,100,0
2,1,100,False,47.0,0.21105691606772742,122.95,50,50
2,2,5,True,45.0,0.0,5.800000000000001,5,0
2,2,5,False,61.0,0.0,5.800000000000001,5,0
2,2,10,True,61.0,0.0,5.800000000000001,10,0
2,2,10,False,61.0,0.0,5.800000000000001,10,0
2,2,15,True,51.0,0.0,5.800000000000001,15,0
2,2,15,False,51.0,0.0,5.800000000000001,15,0
2,2,20,True,54.0,0.0,5.800000000000001,20,0
2,2,20,False,49.0,0.0,5.800000000000001,20,0
2,2,25,True,49.0,0.0,5.800000000000001,25,0
2,2,25,False,98.0,0.07484226754179027,113.45,12,13
2,2,30,True,56.0,0.0,5.800000000000001,30,0
2,2,30,False,98.0,0.1096784101621719,85.80000000000001,15,15
2,2,35,True,57.0,0.0,5.800000000000001,35,0
2,2,35,False,98.0,0.13080047332939024,,18,17
2,2,40,True,58.0,0.0062265831576001855,239.9,20,20
2,2,40,False,99.0,0.15683990688537597,99.9,20,20
2,2,45,True,52.0,0.004747904833431457,157.25,23,22
2,2,45,False,99.0,0.16297646911442468,132.75,22,23
2,2,50,True,61.0,0.0,5.800000000000001,50,0
2,2,50,False,100.0,0.1766405541930244,129.70000000000002,25,25
2,2,55,True,49.0,0.0,5.800000000000001,55,0
2,2,55,False,100.0,0.18206955749482523,121.30000000000001,28,27
2,2,60,True,56.0,0.0,5.800000000000001,60,0
2,2,60,False,100.0,0.19101096766402476,86.35000000000001,30,30
2,2,65,True,53.0,0.0,5.800000000000001,65,0
2,2,65,False,99.0,0.18965456152237675,72.60000000000001,33,32
2,2,70,True,49.0,0.0,5.800000000000001,70,0
2,2,70,False,100.0,0.1984718138509377,99.25,35,35
2,2,75,True,54.0,0.0,5.800000000000001,75,0
2,2,75,False,100.0,0.19858235589697354,128.8,38,37
2,2,80,True,46.0,0.0,5.800000000000001,80,0
2,2,80,False,100.0,0.20644091404448742,126.85000000000001,40,40
2,2,85,True,57.0,0.0,5.800000000000001,85,0
2,2,85,False,99.0,0.2011373107099971,139.6,42,43
2,2,90,True,49.0,0.0,5.800000000000001,90,0
2,2,90,False,100.0,0.21179421938198756,31.8,45,45
2,2,95,True,41.0,0.0,5.800000000000001,95,0
2,2,95,False,100.0,0.21404239709722178,129.45000000000002,48,47
2,2,100,True,54.0,0.0,5.800000000000001,100,0
2,2,100,False,100.0,0.22134464349812719,60.800000000000004,50,50
2,3,5,True,58.0,0.0,5.800000000000001,5,0
2,3,5,False,56.0,0.0,5.800000000000001,5,0
2,3,10,True,44.0,0.0,5.800000000000001,10,0
2,3,10,False,54.0,0.0,5.800000000000001,10,0
2,3,15,True,53.0,0.0,5.800000000000001,15,0
2,3,15,False,45.0,0.0,5.800000000000001,15,0
2,3,20,True,51.0,0.0,5.800000000000001,20,0
2,3,20,False,54.0,0.0,5.800000000000001,20,0
2,3,25,True,43.0,0.0,5.800000000000001,25,0
2,3,25,False,98.0,0.07209265041977889,159.05,13,12
2,3,30,True,65.0,0.0,5.800000000000001,30,0
2,3,30,False,98.0,0.10710872815410111,76.45,15,15
2,3,35,True,53.0,0.00018919510534448983,140.70000000000002,16,19
2,3,35,False,99.0,0.11816822080636138,145.45000000000002,18,17
2,3,40,True,47.0,0.0004834466856232926,129.65,19,21
2,3,40,False,97.0,0.1436679019364147,76.5,20,20
2,3,45,True,53.0,0.0027570758778757702,129.95000000000002,22,23
2,3,45,False,99.0,0.15194127014879644,151.05,23,22
2,3,50,True,51.0,0.0012536601431798618,124.15,25,25
2,3,50,False,95.0,0.15998237609248808,71.0,25,25
2,3,55,True,51.0,0.011808122028824726,116.30000000000001,28,27
2,3,55,False,97.0,0.16748173627687704,294.85,27,28
2,3,60,True,51.0,0.010050516150388046,183.65,30,30
2,3,60,False,53.0,0.0011091311333020564,,0,60
2,3,65,True,55.0,0.027906775395623973,143.1,33,32
2,3,65,False,46.0,0.06700315878919602,108.25,32,33
2,3,70,True,52.0,0.015620207200339993,172.10000000000002,51,19
2,3,70,False,91.0,0.2238518181370167,59.550000000000004,35,35
2,3,75,True,54.0,0.0023908878206059443,148.35,6,69
2,3,75,False,98.0,0.20669410242223926,,37,38
2,3,80,True,50.0,0.052248102986188795,16.5,39,41
2,3,80,False,47.0,0.04440157701281451,174.85000000000002,40,40
2,3,85,True,51.0,0.022898570455712343,251.9,3,82
2,3,85,False,44.0,0.09637217952121278,128.95000000000002,75,10
2,3,90,True,49.0,0.06122928528884955,168.10000000000002,45,45
2,3,90,False,92.0,0.20779677680116038,105.9,45,45
2,3,95,True,51.0,0.012535061183009606,199.9,68,27
2,3,95,False,49.0,0.07655018037411623,,47,48
2,3,100,True,62.0,0.17180362876508903,251.35000000000002,50,50
2,3,100,False,65.0,0.1836160549778578,319.1,50,50
2,4,5,True,57.0,0.0,5.800000000000001,5,0
2,4,5,False,47.0,0.0,5.800000000000001,5,0
2,4,10,True,48.0,0.0,5.800000000000001,10,0
2,4,10,False,56.0,0.0,5.800000000000001,10,0
2,4,15,True,64.0,0.0,5.800000000000001,15,0
2,4,15,False,55.0,0.0,5.800000000000001,15,0
2,4,20,True,50.0,0.0,5.800000000000001,20,0
2,4,20,False,52.0,0.0,5.800000000000001,20,0
2,4,25,True,54.0,0.0,5.800000000000001,25,0
2,4,25,False,97.0,0.07450969427018952,68.10000000000001,13,12
2,4,30,True,57.0,0.0,5.800000000000001,30,0
2,4,30,False,96.0,0.10575291311058113,91.45,15,15
2,4,35,True,47.0,0.0,5.800000000000001,35,0
2,4,35,False,97.0,0.12880625879811264,137.8,17,18
2,4,40,True,43.0,0.0,5.800000000000001,40,0
2,4,40,False,98.0,0.1398120665337721,43.35,20,20
2,4,45,True,46.0,0.0,5.800000000000001,45,0
2,4,45,False,95.0,0.14586795080777598,60.1,23,22
2,4,50,True,55.0,0.0,5.800000000000001,50,0
2,4,50,False,52.0,0.0031783032219881487,145.95000000000002,0,50
2,4,55,True,52.0,0.0,5.800000000000001,55,0
2,4,55,False,100.0,0.23142888746510856,101.2,27,28
2,4,60,True,45.0,0.0005739356822460047,52.7,21,39
2,4,60,False,58.0,0.08542634144380204,73.8,0,60
2,4,65,True,55.0,0.0003246988669225645,134.35,32,33
2,4,65,False,94.0,0.2350825273453421,38.95,33,32
2,4,70,True,51.0,0.0012010108328521527,,68,2
2,4,70,False,100.0,0.2154267620027075,98.35000000000001,35,35
2,4,75,True,53.0,0.0014780668653616683,105.9,36,39
2,4,75,False,100.0,0.23684843704609296,93.60000000000001,37,38
2,4,80,True,55.0,0.0016688834904142586,126.80000000000001,48,32
2,4,80,False,98.0,0.2163160232973496,99.55000000000001,40,40
2,4,85,True,48.0,0.0067586214120595985,21.6,66,19
2,4,85,False,99.0,0.2119949072874226,172.65,42,43
2,4,90,True,53.0,0.001959938493558415,105.7,24,66
2,4,90,False,99.0,0.22295612835399495,256.40000000000003,45,45
2,4,95,True,48.0,0.0005405152593898624,274.3,24,71
2,4,95,False,97.0,0.22648173038307684,140.20000000000002,51,44
2,4,100,True,54.0,0.14812734274154607,,52,48
2,4,100,False,54.0,0.20314644681128982,99.35000000000001,50,50
2,5,5,True,60.0,0.0,5.800000000000001,5,0
2,5,5,False,61.0,0.0,5.800000000000001,5,0
2,5,10,True,54.0,0.0,5.800000000000001,10,0
2,5,10,False,57.0,0.0,5.800000000000001,10,0
2,5,15,True,56.0,0.0,5.800000000000001,15,0
2,5,15,False,53.0,0.0,5.800000000000001,15,0
2,5,20,True,66.0,0.0,5.800000000000001,20,0
2,5,20,False,53.0,0.0,5.800000000000001,20,0
2,5,25,True,56.0,0.0,5.800000000000001,25,0
2,5,25,False,98.0,0.07258333920081063,94.30000000000001,12,13
2,5,30,True,52.0,0.0,5.800000000000001,30,0
2,5,30,False,98.0,0.10869574571241233,72.45,15,15
2,5,35,True,55.0,0.0,5.800000000000001,35,0
2,5,35,False,98.0,0.12120303327651548,93.4,17,18
2,5,40,True,62.0,0.0,5.800000000000001,40,0
2,5,40,False,98.0,0.15291275082546552,185.55,20,20
2,5,45,True,42.0,0.0,5.800000000000001,45,0
2,5,45,False,100.0,0.1555191423029847,74.8,22,23
2,5,50,True,58.0,2.533853561456467e-05,14.55,21,29
2,5,50,False,100.0,0.20841777766475594,156.35000000000002,25,25
2,5,55,True,55.0,0.0029509187873892747,54.35,31,24
2,5,55,False,100.0,0.21141921108225317,55.300000000000004,27,28
2,5,60,True,51.0,0.004634234199886427,349.95000000000005,36,24
2,5,60,False,100.0,0.2386799228125167,122.85000000000001,30,30
2,5,65,True,54.0,0.0032314790768753552,19.200000000000003,24,41
2,5,65,False,64.0,0.005464074652681612,200.75,1,64
2,5,70,True,51.0,0.0024597934858834945,,5,65
2,5,70,False,43.0,0.07230316788409175,,70,0
2,5,75,True,54.0,0.000705535830680949,,5,70
2,5,75,False,94.0,0.21626002162402808,104.65,37,38
2,5,80,True,53.0,0.019829159319749656,,76,4
2,5,80,False,100.0,0.2474421796851408,93.7,40,40
2,5,85,True,54.0,0.0010635135685102312,64.25,7,78
2,5,85,False,99.0,0.21698929591453356,95.30000000000001,43,42
2,5,90,True,58.0,0.023079109956126595,,45,45
2,5,90,False,100.0,0.2343273138319431,105.45,46,44
2,5,95,True,60.0,0.09655508648125195,54.550000000000004,47,48
2,5,95,False,76.0,0.1608069068585963,,55,40
2,5,100,True,46.0,0.11532199996270753,201.60000000000002,49,51
2,5,100,False,51.0,0.21180053399840654,162.9,50,50
2,6,5,True,56.0,0.0,5.800000000000001,5,0
2,6,5,False,56.0,0.0,5.800000000000001,5,0
2,6,10,True,57.0,0.0,5.800000000000001,10,0
2,6,10,False,56.0,0.0,5.800000000000001,10,0
2,6,15,True,49.0,0.0,5.800000000000001,15,0
2,6,15,False,46.0,0.0,5.800000000000001,15,0
2,6,20,True,54.0,0.0,5.800000000000001,20,0
2,6,20,False,56.0,0.0,5.800000000000001,20,0
2,6,25,True,49.0,0.0,5.800000000000001,25,0
2,6,25,False,91.0,0.07715442187216306,130.95000000000002,12,13
2,6,30,True,56.0,0.0,5.800000000000001,30,0
2,6,30,False,98.0,0.10748497058757678,74.25,15,15
2,6,35,True,51.0,0.0,5.800000000000001,35,0
2,6,35,False,98.0,0.12489801586553341,127.80000000000001,17,18
2,6,40,True,54.0,0.0,5.800000000000001,40,0
2,6,40,False,99.0,0.14457028132356378,70.2,20,20
2,6,45,True,49.0,8.729986954535695e-05,82.55000000000001,6,39
2,6,45,False,100.0,0.17064292388426952,129.95000000000002,22,23
2,6,50,True,58.0,0.006520157025281183,80.25,25,25
2,6,50,False,50.0,0.06374507207834956,86.05000000000001,50,0
2,6,55,True,62.0,0.007284571378628577,227.15,54,1
2,6,55,False,86.0,0.19804165054513487,54.5,0,55
2,6,60,True,65.0,0.08539354436275017,58.5,30,30
2,6,60,False,100.0,0.21098923910419307,146.85,30,30
2,6,65,True,63.0,0.10866447340540361,,33,32
2,6,65,False,100.0,0.2041944315795938,127.7,32,33
2,6,70,True,55.0,0.07463103316243581,28.75,35,35
2,6,70,False,100.0,0.21487516940197407,49.900000000000006,35,35
2,6,75,True,65.0,0.011267664080872503,108.95,36,39
2,6,75,False,62.0,0.20548091558437057,58.300000000000004,38,37
2,6,80,True,63.0,0.10824613350260211,171.65,40,40
2,6,80,False,99.0,0.21139288515798318,102.5,40,40
2,6,85,True,59.0,0.088489218939394,,43,42
2,6,85,False,100.0,0.21762371428103397,132.20000000000002,42,43
2,6,90,True,58.0,0.007421778964427622,124.80000000000001,45,45
2,6,90,False,100.0,0.23424857117963807,144.05,45,45
2,6,95,True,52.0,0.0025152108669631553,245.75,13,82
2,6,95,False,100.0,0.24093257900207243,127.5,47,48
2,6,100,True,48.0,0.11222146523768785,,41,59
2,6,100,False,52.0,0.18871613933652423,67.5,50,50
2,7,5,True,48.0,0.0,5.800000000000001,5,0
2,7,5,False,50.0,0.0,5.800000000000001,5,0
2,7,10,True,59.0,0.0,5.800000000000001,10,0
2,7,10,False,53.0,0.0,5.800000000000001,10,0
2,7,15,True,61.0,0.0,5.800000000000001,15,0
2,7,15,False,51.0,0.0,5.800000000000001,15,0
2,7,20,True,49.0,0.0,5.800000000000001,20,0
2,7,20,False,52.0,0.0003106194012625589,97.45,5,15
2,7,25,True,47.0,0.0,5.800000000000001,25,0
2,7,25,False,98.0,0.08080742245333428,112.85000000000001,12,13
2,7,30,True,53.0,0.0,5.800000000000001,30,0
2,7,30,False,97.0,0.11273808948050729,82.85000000000001,15,15
2,7,35,True,59.0,0.0,5.800000000000001,35,0
2,7,35,False,100.0,0.1268932310880364,52.650000000000006,17,18
2,7,40,True,53.0,9.419246963099702e-05,297.45,23,17
2,7,40,False,100.0,0.17721287603869226,131.1,20,20
2,7,45,True,36.0,0.0011226043888676012,29.900000000000002,30,15
2,7,45,False,100.0,0.18952989504503284,163.55,22,23
2,7,50,True,45.0,0.002955589022701787,40.1,23,27
2,7,50,False,100.0,0.17440656785689254,93.85000000000001,25,25
2,7,55,True,65.0,0.10597167518355133,,27,28
2,7,55,False,100.0,0.23832926122960899,81.15,27,28
2,7,60,True,50.0,0.011689441481066608,,58,2
2,7,60,False,100.0,0.2457034158608347,100.2,30,30
2,7,65,True,58.0,0.01877219924867959,138.20000000000002,33,32
2,7,65,False,81.0,0.13906733149154657,69.95,64,1
2,7,70,True,52.0,0.11285349456589333,,35,35
2,7,70,False,95.0,0.1945320355572595,150.0,35,35
2,7,75,True,48.0,0.0003818649337766009,104.0,46,29
2,7,75,False,98.0,0.20409204197051153,121.9,37,38
2,7,80,True,45.0,0.003664801011394081,195.10000000000002,35,45
2,7,80,False,98.0,0.22069493057294085,127.60000000000001,40,40
2,7,85,True,52.0,0.011254932314594708,92.75,41,44
2,7,85,False,100.0,0.2255811676861715,237.65,42,43
2,7,90,True,46.0,0.04430001971234159,84.0,41,49
2,7,90,False,93.0,0.23306715966101194,101.4,45,45
2,7,95,True,62.0,0.12731198492376816,113.5,48,47
2,7,95,False,47.0,0.1907792278106752,88.10000000000001,11,84
2,7,100,True,45.0,0.02171929412550235,40.150000000000006,12,88
2,7,100,False,53.0,0.11340893717037613,194.20000000000002,50,50
2,8,5,True,64.0,0.0,5.800000000000001,5,0
2,8,5,False,67.0,0.0,5.800000000000001,5,0
2,8,10,True,52.0,0.0,5.800000000000001,10,0
2,8,10,False,48.0,0.0,5.800000000000001,10,0
2,8,15,True,48.0,0.0,5.800000000000001,15,0
2,8,15,False,47.0,0.0,5.800000000000001,15,0
2,8,20,True,51.0,0.0,5.800000000000001,20,0
2,8,20,False,62.0,0.0,5.800000000000001,20,0
2,8,25,True,52.0,0.0,5.800000000000001,25,0
2,8,25,False,99.0,0.08249506468340254,90.75,12,13
2,8,30,True,56.0,0.0,5.800000000000001,30,0
2,8,30,False,99.0,0.10526991625451806,82.2,15,15
2,8,35,True,54.0,0.0,5.800000000000001,35,0
2,8,35,False,100.0,0.12705564364304198,55.1,17,18
2,8,40,True,57.0,0.0,5.800000000000001,40,0
2,8,40,False,100.0,0.14544394833901453,207.25,20,20
2,8,45,True,57.0,3.8054345724528194e-05,,11,34
2,8,45,False,100.0,0.16556642587191145,137.1,22,23
2,8,50,True,59.0,0.0001369935526717988,,9,41
2,8,50,False,100.0,0.18281192279960348,76.10000000000001,25,25
2,8,55,True,56.0,0.00011630314719404614,,3,52
2,8,55,False,100.0,0.17084100908169944,134.65,27,28
2,8,60,True,61.0,0.00026332579097929255,202.5,37,23
2,8,60,False,99.0,0.17843126283970595,,30,30
2,8,65,True,86.0,0.13656751472252268,294.40000000000003,33,32
2,8,65,False,97.0,0.18176138165128847,93.65,32,33
2,8,70,True,87.0,0.1529365348767867,184.8,35,35
2,8,70,False,98.0,0.19824499575446294,98.5,35,35
2,8,75,True,83.0,0.14754384447974314,,38,37
2,8,75,False,98.0,0.20848586439965622,121.05000000000001,37,38
2,8,80,True,87.0,0.16233222720734766,,40,40
2,8,80,False,98.0,0.21464448425656785,92.05000000000001,40,40
2,8,85,True,55.0,0.02411743790431524,201.0,42,43
2,8,85,False,99.0,0.20869398448053744,,42,43
2,8,90,True,77.0,0.12068970543127822,216.15,46,44
2,8,90,False,100.0,0.24358300046133746,127.55000000000001,45,45
2,8,95,True,38.0,0.03223445982285786,,61,34
2,8,95,False,99.0,0.23025283785254932,145.70000000000002,48,47
2,8,100,True,47.0,0.018759669300754275,215.35000000000002,28,72
2,8,100,False,48.0,0.123695397818468,205.10000000000002,50,50
2,9,5,True,51.0,0.0,5.800000000000001,5,0
2,9,5,False,50.0,0.0,5.800000000000001,5,0
2,9,10,True,59.0,0.0,5.800000000000001,10,0
2,9,10,False,46.0,0.0,5.800000000000001,10,0
2,9,15,True,53.0,0.0,5.800000000000001,15,0
2,9,15,False,57.0,0.0,5.800000000000001,15,0
2,9,20,True,58.0,0.0,5.800000000000001,20,0
2,9,20,False,43.0,0.0,5.800000000000001,20,0
2,9,25,True,53.0,0.0,5.800000000000001,25,0
2,9,25,False,99.0,0.07430777593266565,74.60000000000001,13,12
2,9,30,True,52.0,0.0,5.800000000000001,30,0
2,9,30,False,99.0,0.10591579647312349,95.60000000000001,15,15
2,9,35,True,58.0,0.0,5.800000000000001,35,0
2,9,35,False,100.0,0.1266833960317266,110.80000000000001,17,18
2,9,40,True,51.0,0.0,5.800000000000001,40,0
2,9,40,False,99.0,0.13575670594793887,84.15,20,20
2,9,45,True,59.0,2.5470956348556318e-05,192.15,16,29
2,9,45,False,57.0,0.009891914621340895,188.0,0,45
2,9,50,True,55.0,0.0014586396582086563,97.80000000000001,2,48
2,9,50,False,98.0,0.16203808594675695,101.45,25,25
2,9,55,True,83.0,0.05926293146559189,25.25,28,27
2,9,55,False,100.0,0.18118022062212708,61.95,27,28
2,9,60,True,54.0,0.0,5.800000000000001,60,0
2,9,60,False,99.0,0.1812360973339529,130.85,30,30
2,9,65,True,56.0,0.004233560462323167,110.60000000000001,38,27
2,9,65,False,96.0,0.18648287563139282,128.85,32,33
2,9,70,True,91.0,0.1647023190078936,307.3,35,35
2,9,70,False,98.0,0.18068971849529256,91.45,35,35
2,9,75,True,83.0,0.1527638256888781,,38,37
2,9,75,False,98.0,0.1944444925928264,24.200000000000003,37,38
2,9,80,True,88.0,0.17156683970831516,160.4,41,39
2,9,80,False,100.0,0.2433900991442194,57.0,40,40
2,9,85,True,87.0,0.15107982652415994,,43,42
2,9,85,False,99.0,0.21676405846746535,170.95000000000002,43,42
2,9,90,True,53.0,0.02726158845718729,105.5,82,8
2,9,90,False,98.0,0.2132260505694819,128.6,46,44
2,9,95,True,78.0,0.12305760635660712,163.20000000000002,49,46
2,9,95,False,99.0,0.2262553940452935,,47,48
2,9,100,True,41.0,0.05233967730355105,100.55000000000001,28,72
2,9,100,False,47.0,0.0605688929254583,68.60000000000001,55,45
2,10,5,True,60.0,0.0,5.800000000000001,5,0
2,10,5,False,43.0,0.0,5.800000000000001,5,0
2,10,10,True,54.0,0.0,5.800000000000001,10,0
2,10,10,False,50.0,0.0,5.800000000000001,10,0
2,10,15,True,57.0,0.0,5.800000000000001,15,0
2,10,15,False,54.0,0.0,5.800000000000001,15,0
2,10,20,True,63.0,0.0,5.800000000000001,20,0
2,10,20,False,59.0,0.0,5.800000000000001,20,0
2,10,25,True,56.0,0.0,5.800000000000001,25,0
2,10,25,False,99.0,0.07887078931469062,93.30000000000001,12,13
2,10,30,True,61.0,0.0,5.800000000000001,30,0
2,10,30,False,100.0,0.10501706890307144,134.25,15,15
2,10,35,True,61.0,0.0,5.800000000000001,35,0
2,10,35,False,100.0,0.13291345797782203,101.75,17,18
2,10,40,True,63.0,1.979068791995158e-05,,12,28
2,10,40,False,100.0,0.1935635639187573,135.6,20,20
2,10,45,True,48.0,0.00010197844510529578,146.55,0,45
2,10,45,False,100.0,0.16855290054729152,65.60000000000001,22,23
2,10,50,True,58.0,0.02385329464237187,,25,25
2,10,50,False,98.0,0.15523237957074276,108.10000000000001,25,25
2,10,55,True,52.0,0.0003617059925316212,157.75,25,30
2,10,55,False,73.0,0.11320531210757184,30.150000000000002,54,1
2,10,60,True,92.0,0.15658252114273147,282.85,30,30
2,10,60,False,97.0,0.1791845788031215,44.0,30,30
2,10,65,True,70.0,0.14447306066805315,324.40000000000003,32,33
2,10,65,False,95.0,0.18478318920159859,94.10000000000001,32,33
2,10,70,True,90.0,0.156725439227356,227.85000000000002,35,35
2,10,70,False,99.0,0.1975700660208138,138.5,35,35
2,10,75,True,90.0,0.16001805210956152,328.25,38,37
2,10,75,False,97.0,0.19144451749628222,130.85,38,37
2,10,80,True,82.0,0.16319326026533834,91.4,40,40
2,10,80,False,97.0,0.19414998172394907,175.55,40,40
2,10,85,True,85.0,0.1511760172540501,215.35000000000002,44,41
2,10,85,False,98.0,0.20952938387113884,100.10000000000001,42,43
2,10,90,True,87.0,0.1846218569279682,222.10000000000002,45,45
2,10,90,False,99.0,0.21318373385240189,7.4,45,45
2,10,95,True,87.0,0.21770976877601333,148.6,47,48
2,10,95,False,97.0,0.2175956916285877,129.20000000000002,47,48
2,10,100,True,51.0,0.03445409643330805,38.800000000000004,99,1
2,10,100,False,41.0,0.05118057144821473,72.0,56,44
3,0,5,True,65.0,0.0,5.800000000000001,5,0
3,0,5,False,55.0,0.0,5.800000000000001,5,0
3,0,10,True,53.0,0.0,5.800000000000001,10,0
3,0,10,False,58.0,0.0,5.800000000000001,10,0
3,0,15,True,51.0,0.0,5.800000000000001,15,0
3,0,15,False,56.0,0.0,5.800000000000001,15,0
3,0,20,True,56.0,0.0,5.800000000000001,20,0
3,0,20,False,57.0,0.0,5.800000000000001,20,0
3,0,25,True,46.0,0.0,5.800000000000001,25,0
3,0,25,False,51.0,5.3857110004997126e-05,97.4,0,25
3,0,30,True,60.0,0.0,5.800000000000001,30,0
3,0,30,False,98.0,0.11073036721790382,141.05,15,15
3,0,35,True,47.0,0.0,5.800000000000001,35,0
3,0,35,False,97.0,0.12271743710237963,95.85000000000001,17,18
3,0,40,True,57.0,0.0,5.800000000000001,40,0
3,0,40,False,98.0,0.14302136580092747,113.15,20,20
3,0,45,True,59.0,0.0,5.800000000000001,45,0
3,0,45,False,97.0,0.1509241729709856,99.80000000000001,23,22
3,0,50,True,51.0,0.0,5.800000000000001,50,0
3,0,50,False,98.0,0.17726204770206352,207.35000000000002,25,25
3,0,55,True,52.0,0.13783489246814287,226.8,28,27
3,0,55,False,100.0,0.28117488949595826,26.8,27,28
3,0,60,True,55.0,0.0035148452757190053,159.0,30,30
3,0,60,False,99.0,0.18639018390199785,125.85000000000001,30,30
3,0,65,True,55.0,0.0032387203382769616,163.35000000000002,33,32
3,0,65,False,97.0,0.20152004309036914,97.75,32,33
3,0,70,True,63.0,0.001207483064176545,120.9,35,35
3,0,70,False,98.0,0.22429261620303992,,35,35
3,0,75,True,62.0,0.0005417488890109166,123.7,41,34
3,0,75,False,98.0,0.22430192380932495,34.35,38,37
3,0,80,True,52.0,0.0019338300371942064,162.5,39,41
3,0,80,False,99.0,0.22544613008851772,111.75,40,40
3,0,85,True,57.0,0.005949180348133299,132.0,43,42
3,0,85,False,98.0,0.2269156973295847,156.75,43,42
3,0,90,True,49.0,0.004780116629923318,105.65,18,72
3,0,90,False,98.0,0.22815336649138954,81.60000000000001,45,45
3,0,95,True,51.0,0.06063642118730171,139.70000000000002,71,24
3,0,95,False,49.0,0.0668885259968761,143.65,47,48
3,0,100,True,51.0,0.0006428208933765453,80.85000000000001,46,54
3,0,100,False,98.0,0.21844554247871634,72.05,50,50
3,1,5,True,56.0,0.0,5.800000000000001,5,0
3,1,5,False,49.0,0.0,5.800000000000001,5,0
3,1,10,True,54.0,0.0,5.800000000000001,10,0
3,1,10,False,50.0,0.0,5.800000000000001,10,0
3,1,15,True,59.0,0.0,5.800000000000001,15,0
3,1,15,False,57.0,0.0,5.800000000000001,15,0
3,1,20,True,53.0,0.0,5.800000000000001,20,0
3,1,20,False,56.0,0.0,5.800000000000001,20,0
3,1,25,True,58.0,0.0,5.800000000000001,25,0
3,1,25,False,98.0,0.06761485813933168,71.85000000000001,12,13
3,1,30,True,48.0,0.0,5.800000000000001,30,0
3,1,30,False,98.0,0.10702265210532719,78.0,15,15
3,1,35,True,58.0,0.0,5.800000000000001,35,0
3,1,35,False,98.0,0.12051430341803715,156.35000000000002,18,17
3,1,40,True,48.0,0.0,5.800000000000001,40,0
3,1,40,False,98.0,0.1461566476956613,98.30000000000001,20,20
3,1,45,True,48.0,0.0,5.800000000000001,45,0
3,1,45,False,52.0,0.1573762868898949,71.10000000000001,23,22
3,1,50,True,48.0,0.0,5.800000000000001,50,0
3,1,50,False,45.0,0.16275511397742773,91.4,28,22
3,1,55,True,54.0,0.0,5.800000000000001,55,0
3,1,55,False,43.0,0.15633995119479688,77.65,30,25
3,1,60,True,58.0,0.0,5.800000000000001,60,0
3,1,60,False,53.0,0.1631083229936487,133.6,35,25
3,1,65,True,53.0,0.0,5.800000000000001,65,0
3,1,65,False,40.0,0.15647953080822952,165.0,37,28
3,1,70,True,53.0,0.0,5.800000000000001,70,0
3,1,70,False,41.0,0.16329064875655433,191.10000000000002,40,30
3,1,75,True,50.0,0.0,5.800000000000001,75,0
3,1,75,False,41.0,0.17853358883269857,106.4,43,32
3,1,80,True,54.0,0.0,5.800000000000001,80,0
3,1,80,False,44.0,0.18318853286192024,107.30000000000001,44,36
3,1,85,True,53.0,0.0,5.800000000000001,85,0
3,1,85,False,50.0,0.18298032606070777,99.55000000000001,45,40
3,1,90,True,55.0,0.0,5.800000000000001,90,0
3,1,90,False,40.0,0.1935979568560784,53.1,45,45
3,1,95,True,57.0,0.0,5.800000000000001,95,0
3,1,95,False,45.0,0.20320334491971556,128.5,47,48
3,1,100,True,47.0,0.0,5.800000000000001,100,0
3,1,100,False,100.0,0.22298127662316078,102.9,50,50
3,2,5,True,51.0,0.0,5.800000000000001,5,0
3,2,5,False,52.0,0.0,5.800000000000001,5,0
3,2,10,True,58.0,0.0,5.800000000000001,10,0
3,2,10,False,41.0,0.0,5.800000000000001,10,0
3,2,15,True,51.0,0.0,5.800000000000001,15,0
3,2,15,False,58.0,0.0,5.800000000000001,15,0
3,2,20,True,56.0,0.0,5.800000000000001,20,0
3,2,20,False,53.0,0.0,5.800000000000001,20,0
3,2,25,True,55.0,0.0,5.800000000000001,25,0
3,2,25,False,99.0,0.07481228243084155,167.70000000000002,13,12
3,2,30,True,55.0,0.0,5.800000000000001,30,0
3,2,30,False,97.0,0.10910694027208752,105.60000000000001,15,15
3,2,35,True,56.0,0.0,5.800000000000001,35,0
3,2,35,False,98.0,0.1263971979892098,70.75,18,17
3,2,40,True,59.0,0.010291572127271135,180.65,20,20
3,2,40,False,100.0,0.15524415104020473,165.55,20,20
3,2,45,True,54.0,0.00028614898438782165,153.0,23,22
3,2,45,False,100.0,0.1659114467380411,104.25,22,23
3,2,50,True,54.0,0.00025988249999961155,72.95,50,0
3,2,50,False,99.0,0.17982135162705076,303.3,25,25
3,2,55,True,54.0,0.0,5.800000000000001,55,0
3,2,55,False,100.0,0.18208847272402073,75.25,28,27
3,2,60,True,59.0,0.0,5.800000000000001,60,0
3,2,60,False,100.0,0.18686520073823915,68.65,30,30
3,2,65,True,51.0,0.0,5.800000000000001,65,0
3,2,65,False,100.0,0.19311522637488315,99.45,32,33
3,2,70,True,53.0,0.0,5.800000000000001,70,0
3,2,70,False,100.0,0.19825410507325267,93.5,35,35
3,2,75,True,54.0,0.0,5.800000000000001,75,0
3,2,75,False,100.0,0.2016689146976271,77.55000000000001,37,38
3,2,80,True,59.0,0.0,5.800000000000001,80,0
3,2,80,False,100.0,0.20582849072372136,81.10000000000001,40,40
3,2,85,True,52.0,0.0,5.800000000000001,85,0
3,2,85,False,100.0,0.20403024535153913,165.05,42,43
3,2,90,True,57.0,0.0,5.800000000000001,90,0
3,2,90,False,99.0,0.21260287983989695,166.45000000000002,45,45
3,2,95,True,54.0,0.0,5.800000000000001,95,0
3,2,95,False,100.0,0.20927505980953565,129.25,47,48
3,2,100,True,51.0,0.0,5.800000000000001,100,0
3,2,100,False,99.0,0.2160798762199767,76.35000000000001,50,50
3,3,5,True,51.0,0.0,5.800000000000001,5,0
3,3,5,False,51.0,0.0,5.800000000000001,5,0
3,3,10,True,60.0,0.0,5.800000000000001,10,0
3,3,10,False,56.0,0.0,5.800000000000001,10,0
3,3,15,True,44.0,0.0,5.800000000000001,15,0
3,3,15,False,52.0,0.0,5.800000000000001,15,0
3,3,20,True,59.0,0.0,5.800000000000001,20,0
3,3,20,False,54.0,0.0,5.800000000000001,20,0
3,3,25,True,68.0,0.0,5.800000000000001,25,0
3,3,25,False,98.0,0.07570413613436329,98.30000000000001,12,13
3,3,30,True,55.0,0.0,5.800000000000001,30,0
3,3,30,False,98.0,0.10395085030436818,67.8,15,15
3,3,35,True,59.0,0.0007254827621693116,128.3,22,13
3,3,35,False,98.0,0.12381445993011615,96.30000000000001,18,17
3,3,40,True,59.0,0.006096269742949327,121.10000000000001,20,20
3,3,40,False,97.0,0.13298302548014032,82.35000000000001,20,20
3,3,45,True,47.0,0.0013758100140105038,164.25,22,23
3,3,45,False,97.0,0.1501639080056016,139.65,23,22
3,3,50,True,54.0,0.0015037751739105244,122.80000000000001,25,25
3,3,50,False,97.0,0.19256885070224514,79.10000000000001,25,25
3,3,55,True,51.0,0.0074358544380880125,193.70000000000002,27,28
3,3,55,False,99.0,0.24493892165186912,100.30000000000001,28,27
3,3,60,True,53.0,0.01058796216168272,131.55,29,31
3,3,60,False,42.0,0.0807228839468027,,30,30
3,3,65,True,54.0,0.022331664091478555,147.5,33,32
3,3,65,False,93.0,0.20745069561448937,172.8,33,32
3,3,70,True,55.0,0.05583252908531456,247.25,35,35
3,3,70,False,100.0,0.22098587827003374,,35,35
3,3,75,True,59.0,0.034511626417647656,192.8,38,37
3,3,75,False,52.0,0.1014004501021771,149.5,37,38
3,3,80,True,48.0,0.06523054802689814,279.0,40,40
3,3,80,False,99.0,0.21387188848424638,191.3,40,40
3,3,85,True,54.0,0.0461057206194215,199.10000000000002,43,42
3,3,85,False,91.0,0.2080629807338791,61.35,43,42
3,3,90,True,54.0,0.019921983520326522,94.65,45,45
3,3,90,False,49.0,0.08467577342219061,,45,45
3,3,95,True,50.0,0.17150870516793662,,47,48
3,3,95,False,100.0,0.2169574233506786,130.9,47,48
3,3,100,True,64.0,0.18850427143438664,,50,50
3,3,100,False,56.0,0.1874825899620279,44.650000000000006,50,50
3,4,5,True,60.0,0.0,5.800000000000001,5,0
3,4,5,False,59.0,0.0,5.800000000000001,5,0
3,4,10,True,54.0,0.0,5.800000000000001,10,0
3,4,10,False,49.0,0.0,5.800000000000001,10,0
3,4,15,True,55.0,0.0,5.800000000000001,15,0
3,4,15,False,61.0,0.0,5.800000000000001,15,0
3,4,20,True,59.0,0.0,5.800000000000001,20,0
3,4,20,False,54.0,0.0,5.800000000000001,20,0
3,4,25,True,58.0,0.0,5.800000000000001,25,0
3,4,25,False,97.0,0.07622273254008793,112.05000000000001,12,13
3,4,30,True,50.0,0.0,5.800000000000001,30,0
3,4,30,False,97.0,0.10271689899307035,124.35000000000001,15,15
3,4,35,True,48.0,0.0,5.800000000000001,35,0
3,4,35,False,98.0,0.1161699808677433,100.7,18,17
3,4,40,True,44.0,0.0,5.800000000000001,40,0
3,4,40,False,99.0,0.15619704857694602,172.75,20,20
3,4,45,True,49.0,0.0,5.800000000000001,45,0
3,4,45,False,95.0,0.14368317700505748,65.2,22,23
3,4,50,True,51.0,0.0,5.800000000000001,50,0
3,4,50,False,97.0,0.17475102840508447,106.85000000000001,25,25
3,4,55,True,53.0,0.0,5.800000000000001,55,0
3,4,55,False,98.0,0.16910488337972523,148.6,27,28
3,4,60,True,51.0,7.25206978474157e-05,,0,60
3,4,60,False,93.0,0.19019251396666517,93.95,40,20
3,4,65,True,58.0,0.0004679584464217737,,29,36
3,4,65,False,55.0,0.004997210051393091,244.5,1,64
3,4,70,True,60.0,0.0052189063764943545,,70,0
3,4,70,False,55.0,0.007348754450718469,121.4,0,70
3,4,75,True,55.0,0.013816690076730129,,37,38
3,4,75,False,77.0,0.14625413897613537,66.15,37,38
3,4,80,True,58.0,0.01789702933338737,29.35,40,40
3,4,80,False,100.0,0.2283570968940211,168.45000000000002,40,40
3,4,85,True,51.0,0.028359255821542362,144.05,43,42
3,4,85,False,99.0,0.21863627014605008,84.5,43,42
3,4,90,True,48.0,0.007800697529978292,104.25,45,45
3,4,90,False,100.0,0.24546546213495996,115.85000000000001,47,43
3,4,95,True,58.0,0.0018090019659110226,121.55000000000001,48,47
3,4,95,False,58.0,0.23603159741352114,,47,48
3,4,100,True,50.0,0.09707771208783109,112.85000000000001,49,51
3,4,100,False,48.0,0.2194263167445859,54.25,50,50
3,5,5,True,52.0,0.0,5.800000000000001,5,0
3,5,5,False,54.0,0.0,5.800000000000001,5,0
3,5,10,True,51.0,0.0,5.800000000000001,10,0
3,5,10,False,50.0,0.0,5.800000000000001,10,0
3,5,15,True,53.0,0.0,5.800000000000001,15,0
3,5,15,False,50.0,0.0,5.800000000000001,15,0
3,5,20,True,51.0,0.0,5.800000000000001,20,0
3,5,20,False,56.0,0.0,5.800000000000001,20,0
3,5,25,True,51.0,0.0,5.800000000000001,25,0
3,5,25,False,98.0,0.07380313156676223,166.10000000000002,12,13
3,5,30,True,53.0,0.0,5.800000000000001,30,0
3,5,30,False,97.0,0.1226599954427486,114.75,15,15
3,5,35,True,64.0,0.0,5.800000000000001,35,0
3,5,35,False,97.0,0.12793595529754215,81.85000000000001,17,18
3,5,40,True,59.0,0.0,5.800000000000001,40,0
3,5,40,False,98.0,0.1517646270353597,101.65,20,20
3,5,45,True,54.0,0.0,5.800000000000001,45,0
3,5,45,False,99.0,0.15500567149069053,107.05000000000001,22,23
3,5,50,True,52.0,3.6468040579914893e-05,56.300000000000004,45,5
3,5,50,False,100.0,0.23298039343202862,66.55,25,25
3,5,55,True,51.0,0.0005547274036502345,16.5,0,55
3,5,55,False,100.0,0.2145430689924039,94.85000000000001,27,28
3,5,60,True,53.0,7.068946163831331e-05,,0,60
3,5,60,False,100.0,0.22279987700783832,69.9,30,30
3,5,65,True,54.0,0.03223353975943393,56.300000000000004,32,33
3,5,65,False,51.0,0.04575522433596024,,65,0
3,5,70,True,55.0,0.004880064673847544,202.55,21,49
3,5,70,False,100.0,0.2085078828862051,72.35000000000001,35,35
3,5,75,True,55.0,0.003170993583681148,15.600000000000001,22,53
3,5,75,False,76.0,0.168142574761967,,38,37
3,5,80,True,49.0,0.03008423566671848,101.60000000000001,40,40
3,5,80,False,100.0,0.23642502183144604,111.35000000000001,40,40
3,5,85,True,65.0,0.029666182332217177,274.90000000000003,44,41
3,5,85,False,100.0,0.2220385045007007,105.05000000000001,42,43
3,5,90,True,55.0,0.010351129620237487,135.25,45,45
3,5,90,False,87.0,0.2211409440239791,72.7,45,45
3,5,95,True,65.0,0.000777880535838673,105.60000000000001,95,0
3,5,95,False,55.0,0.07412457958618397,,1,94
3,5,100,True,51.0,0.05590134078155107,142.35,38,62
3,5,100,False,44.0,0.22013297881120128,145.8,50,50
3,6,5,True,52.0,0.0,5.800000000000001,5,0
3,6,5,False,50.0,0.0,5.800000000000001,5,0
3,6,10,True,54.0,0.0,5.800000000000001,10,0
3,6,10,False,51.0,0.0,5.800000000000001,10,0
3,6,15,True,56.0,0.0,5.800000000000001,15,0
3,6,15,False,59.0,0.0,5.800000000000001,15,0
3,6,20,True,57.0,0.0,5.800000000000001,20,0
3,6,20,False,54.0,0.0,5.800000000000001,20,0
3,6,25,True,58.0,0.0,5.800000000000001,25,0
3,6,25,False,99.0,0.0830593445087092,72.95,13,12
3,6,30,True,60.0,0.0,5.800000000000001,30,0
3,6,30,False,93.0,0.11396057662883308,140.9,15,15
3,6,35,True,56.0,0.0,5.800000000000001,35,0
3,6,35,False,98.0,0.12193727513689194,187.95000000000002,17,18
3,6,40,True,54.0,0.0,5.800000000000001,40,0
3,6,40,False,100.0,0.16338765939922376,119.55000000000001,20,20
3,6,45,True,49.0,2.2687151137098267e-05,32.1,6,39
3,6,45,False,100.0,0.1719234051878169,68.85000000000001,22,23
3,6,50,True,58.0,0.00968677780636993,32.0,25,25
3,6,50,False,100.0,0.18543067578141217,102.4,25,25
3,6,55,True,56.0,0.01498350708978767,11.9,28,27
3,6,55,False,100.0,0.24605088357869243,102.7,27,28
3,6,60,True,63.0,0.04800798349424921,,30,30
3,6,60,False,98.0,0.19361513274285422,,30,30
3,6,65,True,57.0,0.03477886127619164,33.300000000000004,53,12
3,6,65,False,100.0,0.1990630717701136,106.2,32,33
3,6,70,True,57.0,0.0029487723302908785,181.45000000000002,40,30
3,6,70,False,100.0,0.24725632687244467,92.05000000000001,35,35
3,6,75,True,50.0,0.07913865535072341,0.6000000000000001,37,38
3,6,75,False,54.0,0.09731112401128758,214.60000000000002,38,37
3,6,80,True,69.0,0.032411630049579525,189.55,40,40
3,6,80,False,74.0,0.20134235762052669,74.85000000000001,40,40
3,6,85,True,52.0,0.08134311618492032,262.55,43,42
3,6,85,False,100.0,0.22683234374885547,80.25,42,43
3,6,90,True,58.0,0.09680240901810606,117.85000000000001,45,45
3,6,90,False,100.0,0.22518179306283304,61.2,46,44
3,6,95,True,55.0,0.07079947239969314,,47,48
3,6,95,False,100.0,0.23237041334722017,42.900000000000006,47,48
3,6,100,True,49.0,0.10692525527423653,109.55000000000001,68,32
3,6,100,False,44.0,0.17530379019160242,223.95000000000002,50,50
3,7,5,True,58.0,0.0,5.800000000000001,5,0
3,7,5,False,50.0,0.0,5.800000000000001,5,0
3,7,10,True,53.0,0.0,5.800000000000001,10,0
3,7,10,False,55.0,0.0,5.800000000000001,10,0
3,7,15,True,56.0,0.0,5.800000000000001,15,0
3,7,15,False,58.0,0.0,5.800000000000001,15,0
3,7,20,True,51.0,0.0,5.800000000000001,20,0
3,7,20,False,51.0,0.0,5.800000000000001,20,0
3,7,25,True,53.0,0.0,5.800000000000001,25,0
3,7,25,False,97.0,0.0748696869728299,54.050000000000004,12,13
3,7,30,True,64.0,0.0,5.800000000000001,30,0
3,7,30,False,99.0,0.1072203941982261,136.6,15,15
3,7,35,True,52.0,0.0,5.800000000000001,35,0
3,7,35,False,100.0,0.12778396962256328,132.25,17,18
3,7,40,True,45.0,8.547555953070997e-06,31.25,40,0
3,7,40,False,100.0,0.1598002457755647,113.25,20,20
3,7,45,True,49.0,0.00047416728650752224,110.85000000000001,33,12
3,7,45,False,100.0,0.15217235130852327,79.2,22,23
3,7,50,True,52.0,0.00030757486274971533,,39,11
3,7,50,False,70.0,0.15792091293876626,64.95,32,18
3,7,55,True,47.0,0.0005302638997677409,,0,55
3,7,55,False,45.0,0.06446474211637192,35.35,44,11
3,7,60,True,53.0,0.0006341670824464637,159.45000000000002,0,60
3,7,60,False,47.0,0.04914397638391668,105.0,60,0
3,7,65,True,56.0,0.06365087862497562,20.400000000000002,33,32
3,7,65,False,48.0,0.0432103170709281,238.4,65,0
3,7,70,True,72.0,0.1314073116558406,140.0,35,35
3,7,70,False,97.0,0.1919747074469248,121.80000000000001,35,35
3,7,75,True,83.0,0.14688154861930697,17.5,38,37
3,7,75,False,79.0,0.18633126665910646,63.650000000000006,0,75
3,7,80,True,55.0,0.0075159692152511545,99.10000000000001,50,30
3,7,80,False,97.0,0.21270511675720233,163.60000000000002,40,40
3,7,85,True,89.0,0.1421715493958166,285.3,44,41
3,7,85,False,100.0,0.21410509295798896,143.75,42,43
3,7,90,True,75.0,0.07797693537063205,,48,42
3,7,90,False,95.0,0.2214603121385208,72.05,45,45
3,7,95,True,57.0,0.08416180986859505,285.95,48,47
3,7,95,False,98.0,0.2368421481193434,123.75,47,48
3,7,100,True,53.0,0.018418099496906676,24.05,99,1
3,7,100,False,45.0,0.13138781250935547,,46,54
3,8,5,True,60.0,0.0,5.800000000000001,5,0
3,8,5,False,61.0,0.0,5.800000000000001,5,0
3,8,10,True,54.0,0.0,5.800000000000001,10,0
3,8,10,False,56.0,0.0,5.800000000000001,10,0
3,8,15,True,52.0,0.0,5.800000000000001,15,0
3,8,15,False,47.0,0.0,5.800000000000001,15,0
3,8,20,True,52.0,0.0,5.800000000000001,20,0
3,8,20,False,51.0,0.0,5.800000000000001,20,0
3,8,25,True,44.0,0.0,5.800000000000001,25,0
3,8,25,False,98.0,0.07845990832376072,127.4,12,13
3,8,30,True,59.0,0.0,5.800000000000001,30,0
3,8,30,False,100.0,0.11465056753382301,172.95000000000002,15,15
3,8,35,True,58.0,0.0,5.800000000000001,35,0
3,8,35,False,99.0,0.13439478310071087,103.95,17,18
3,8,40,True,51.0,0.0,5.800000000000001,40,0
3,8,40,False,98.0,0.13168114747595178,107.2,20,20
3,8,45,True,49.0,8.356623853744166e-05,,34,11
3,8,45,False,100.0,0.16475181673828318,99.30000000000001,22,23
3,8,50,True,57.0,0.00014344307938520985,47.300000000000004,33,17
3,8,50,False,100.0,0.18854193282454065,135.95000000000002,25,25
3,8,55,True,51.0,0.0016095422140304594,,22,33
3,8,55,False,100.0,0.21635547930341578,88.30000000000001,28,27
3,8,60,True,76.0,0.09726116135842272,307.35,30,30
3,8,60,False,96.0,0.17464025656948787,62.1,30,30
3,8,65,True,77.0,0.1162562913750184,61.35,33,32
3,8,65,False,45.0,0.05170053850544498,,49,16
3,8,70,True,55.0,0.02631381009858658,199.05,35,35
3,8,70,False,99.0,0.2056729394205734,63.25,35,35
3,8,75,True,88.0,0.14443079950898027,16.150000000000002,38,37
3,8,75,False,99.0,0.1996605846526435,100.55000000000001,37,38
3,8,80,True,90.0,0.15561872358218576,268.6,40,40
3,8,80,False,99.0,0.21499902136011967,154.65,40,40
3,8,85,True,82.0,0.15349546685503038,66.75,43,42
3,8,85,False,100.0,0.2185485836940869,53.6,43,42
3,8,90,True,75.0,0.12558242407424475,,48,42
3,8,90,False,98.0,0.22096261915462004,135.20000000000002,45,45
3,8,95,True,74.0,0.052343011708163474,119.55000000000001,47,48
3,8,95,False,53.0,0.1484968457497102,36.800000000000004,50,45
3,8,100,True,41.0,0.03000107665216632,185.55,21,79
3,8,100,False,49.0,0.13136887650936668,159.85000000000002,71,29
3,9,5,True,56.0,0.0,5.800000000000001,5,0
3,9,5,False,55.0,0.0,5.800000000000001,5,0
3,9,10,True,49.0,0.0,5.800000000000001,10,0
3,9,10,False,44.0,0.0,5.800000000000001,10,0
3,9,15,True,60.0,0.0,5.800000000000001,15,0
3,9,15,False,55.0,0.0,5.800000000000001,15,0
3,9,20,True,50.0,0.0,5.800000000000001,20,0
3,9,20,False,63.0,0.0002614750099315322,97.30000000000001,3,17
3,9,25,True,58.0,0.0,5.800000000000001,25,0
3,9,25,False,99.0,0.07631305160713481,65.25,12,13
3,9,30,True,59.0,0.0,5.800000000000001,30,0
3,9,30,False,99.0,0.1021954519809857,39.300000000000004,15,15
3,9,35,True,54.0,0.0,5.800000000000001,35,0
3,9,35,False,99.0,0.11689878008377581,98.0,18,17
3,9,40,True,60.0,0.0,5.800000000000001,40,0
3,9,40,False,100.0,0.15215343542835497,58.800000000000004,20,20
3,9,45,True,56.0,6.733896465834657e-07,31.5,21,24
3,9,45,False,100.0,0.16132870614439818,75.15,22,23
3,9,50,True,64.0,0.002484509074579313,,25,25
3,9,50,False,100.0,0.18779263622931536,75.7,25,25
3,9,55,True,74.0,0.08741366503169772,106.15,28,27
3,9,55,False,98.0,0.170884181793369,96.55000000000001,27,28
3,9,60,True,51.0,0.12755137031148214,284.55,30,30
3,9,60,False,97.0,0.183849567327009,80.65,30,30
3,9,65,True,56.0,0.0018053443078523052,,33,32
3,9,65,False,95.0,0.18591950515510355,79.60000000000001,32,33
3,9,70,True,93.0,0.15589772149590517,234.45000000000002,35,35
3,9,70,False,98.0,0.1986563971854419,99.4,35,35
3,9,75,True,83.0,0.14557583460187504,246.25,37,38
3,9,75,False,97.0,0.19725171666478875,81.85000000000001,37,38
3,9,80,True,87.0,0.16026081336093734,,40,40
3,9,80,False,100.0,0.21405254210177674,52.300000000000004,40,40
3,9,85,True,71.0,0.12783791020856977,186.20000000000002,43,42
3,9,85,False,94.0,0.20613358967016182,154.9,42,43
3,9,90,True,78.0,0.1329482460647719,305.75,47,43
3,9,90,False,100.0,0.24495670912503423,183.05,45,45
3,9,95,True,80.0,0.14255891414281097,149.4,48,47
3,9,95,False,97.0,0.22661808424720328,256.65000000000003,49,46
3,9,100,True,39.0,0.00958229992657365,74.15,26,74
3,9,100,False,48.0,0.10591304573182896,,51,49
3,10,5,True,56.0,0.0,5.800000000000001,5,0
3,10,5,False,52.0,0.0,5.800000000000001,5,0
3,10,10,True,60.0,0.0,5.800000000000001,10,0
3,10,10,False,57.0,0.0,5.800000000000001,10,0
3,10,15,True,42.0,0.0,5.800000000000001,15,0
3,10,15,False,49.0,0.0,5.800000000000001,15,0
3,10,20,True,49.0,0.0,5.800000000000001,20,0
3,10,20,False,54.0,0.0002608401688946458,91.80000000000001,3,17
3,10,25,True,56.0,0.0,5.800000000000001,25,0
3,10,25,False,100.0,0.0740318941036486,135.4,13,12
3,10,30,True,56.0,0.0,5.800000000000001,30,0
3,10,30,False,99.0,0.10352879283661537,101.5,15,15
3,10,35,True,53.0,0.0,5.800000000000001,35,0
3,10,35,False,99.0,0.11767742404601557,54.7,17,18
3,10,40,True,53.0,0.0,5.800000000000001,40,0
3,10,40,False,100.0,0.16608979318946449,131.35,20,20
3,10,45,True,55.0,0.00010124941460250492,6.550000000000001,37,8
3,10,45,False,55.0,0.010568756662253922,197.35000000000002,1,44
3,10,50,True,62.0,0.09264273672422162,133.55,25,25
3,10,50,False,100.0,0.20915398658868445,94.2,25,25
3,10,55,True,55.0,0.0018045055789721238,174.3,28,27
3,10,55,False,98.0,0.16960824714446285,131.9,27,28
3,10,60,True,82.0,0.1438235190944173,328.8,30,30
3,10,60,False,96.0,0.18240280644465856,124.05000000000001,30,30
3,10,65,True,93.0,0.15917930240940803,214.0,33,32
3,10,65,False,50.0,0.008501504164008399,138.70000000000002,1,64
3,10,70,True,90.0,0.15554066684399528,216.35000000000002,35,35
3,10,70,False,99.0,0.19589539879360557,60.6,35,35
3,10,75,True,94.0,0.16200752846919855,192.3,38,37
3,10,75,False,98.0,0.19489254776053772,108.80000000000001,37,38
3,10,80,True,93.0,0.17378748695176194,146.15,40,40
3,10,80,False,99.0,0.20304969156769118,102.7,40,40
3,10,85,True,89.0,0.17444926749024323,131.0,43,42
3,10,85,False,96.0,0.20232771479498068,76.0,42,43
3,10,90,True,86.0,0.15846756886774419,157.15,46,44
3,10,90,False,99.0,0.21591390014393178,103.9,45,45
3,10,95,True,82.0,0.19373863077915654,192.45000000000002,48,47
3,10,95,False,96.0,0.21716658125041396,140.9,48,47
3,10,100,True,40.0,0.0755868773895236,,52,48
3,10,100,False,47.0,0.05584262827880404,129.55,55,45
4,0,5,True,54.0,0.0,5.800000000000001,5,0
4,0,5,False,47.0,0.0,5.800000000000001,5,0
4,0,10,True,48.0,0.0,5.800000000000001,10,0
4,0,10,False,56.0,0.0,5.800000000000001,10,0
4,0,15,True,56.0,0.0,5.800000000000001,15,0
4,0,15,False,59.0,0.0,5.800000000000001,15,0
4,0,20,True,48.0,0.0,5.800000000000001,20,0
4,0,20,False,53.0,0.0,5.800000000000001,20,0
4,0,25,True,55.0,0.0,5.800000000000001,25,0
4,0,25,False,98.0,0.07760196365680846,140.45000000000002,13,12
4,0,30,True,47.0,0.0,5.800000000000001,30,0
4,0,30,False,98.0,0.10719247197345803,62.150000000000006,15,15
4,0,35,True,58.0,0.0,5.800000000000001,35,0
4,0,35,False,97.0,0.1245379082323648,145.95000000000002,17,18
4,0,40,True,55.0,0.0,5.800000000000001,40,0
4,0,40,False,97.0,0.1481434291128262,74.55,20,20
4,0,45,True,57.0,0.0,5.800000000000001,45,0
4,0,45,False,98.0,0.1555328487038249,85.0,23,22
4,0,50,True,56.0,0.0,5.800000000000001,50,0
4,0,50,False,98.0,0.17662859854499796,76.25,25,25
4,0,55,True,57.0,0.0003911876972971047,80.55000000000001,55,0
4,0,55,False,100.0,0.2767263926774716,89.85000000000001,28,27
4,0,60,True,53.0,0.0035941012411049916,,30,30
4,0,60,False,98.0,0.20678734211045555,,30,30
4,0,65,True,55.0,0.0015010455809010895,157.60000000000002,33,32
4,0,65,False,98.0,0.21119347520689144,55.550000000000004,32,33
4,0,70,True,54.0,0.0009526289159930336,124.10000000000001,35,35
4,0,70,False,99.0,0.21505050888250793,90.10000000000001,35,35
4,0,75,True,49.0,0.003275156882736232,6.95,2,73
4,0,75,False,97.0,0.22353364895802236,60.800000000000004,38,37
4,0,80,True,58.0,0.00027101588657925613,133.45000000000002,40,40
4,0,80,False,48.0,0.19628810310130423,80.75,39,41
4,0,85,True,64.0,0.0030097770159017967,135.05,43,42
4,0,85,False,99.0,0.20641584570338814,105.80000000000001,42,43
4,0,90,True,49.0,0.047592542597010415,162.35000000000002,36,54
4,0,90,False,99.0,0.21055007651734944,132.25,45,45
4,0,95,True,55.0,0.0003744760548649608,85.05000000000001,92,3
4,0,95,False,98.0,0.2245929390353607,101.30000000000001,48,47
4,0,100,True,50.0,0.00013463111987370004,127.15,58,42
4,0,100,False,98.0,0.23689175357115694,,50,50
4,1,5,True,56.0,0.0,5.800000000000001,5,0
4,1,5,False,51.0,0.0,5.800000000000001,5,0
4,1,10,True,44.0,0.0,5.800000000000001,10,0
4,1,10,False,53.0,0.0,5.800000000000001,10,0
4,1,15,True,56.0,0.0,5.800000000000001,15,0
4,1,15,False,46.0,0.0,5.800000000000001,15,0
4,1,20,True,51.0,0.0,5.800000000000001,20,0
4,1,20,False,45.0,0.0,5.800000000000001,20,0
4,1,25,True,57.0,0.0,5.800000000000001,25,0
4,1,25,False,98.0,0.07952111423810851,128.75,12,13
4,1,30,True,55.0,0.0,5.800000000000001,30,0
4,1,30,False,97.0,0.10742060148492313,74.65,15,15
4,1,35,True,62.0,0.0,5.800000000000001,35,0
4,1,35,False,98.0,0.11997807045878588,119.7,17,18
4,1,40,True,52.0,0.0,5.800000000000001,40,0
4,1,40,False,97.0,0.1470231014606976,78.7,20,20
4,1,45,True,57.0,0.0,5.800000000000001,45,0
4,1,45,False,48.0,0.15564776290809043,68.4,23,22
4,1,50,True,65.0,0.0,5.800000000000001,50,0
4,1,50,False,45.0,0.15707244342876397,96.30000000000001,32,18
4,1,55,True,50.0,0.0,5.800000000000001,55,0
4,1,55,False,54.0,0.15535737368828573,126.2,30,25
4,1,60,True,56.0,0.0,5.800000000000001,60,0
4,1,60,False,54.0,0.16511119724743792,136.25,35,25
4,1,65,True,48.0,0.0,5.800000000000001,65,0
4,1,65,False,47.0,0.15914421174295323,135.0,39,26
4,1,70,True,53.0,0.0,5.800000000000001,70,0
4,1,70,False,49.0,0.17160542169219514,79.10000000000001,40,30
4,1,75,True,54.0,0.0,5.800000000000001,75,0
4,1,75,False,49.0,0.1754648975640419,103.5,43,32
4,1,80,True,51.0,0.0,5.800000000000001,80,0
4,1,80,False,51.0,0.17888630895510327,59.2,41,39
4,1,85,True,55.0,0.0,5.800000000000001,85,0
4,1,85,False,55.0,0.18596244829475347,72.10000000000001,43,42
4,1,90,True,62.0,0.0,5.800000000000001,90,0
4,1,90,False,45.0,0.20380743830736783,103.35000000000001,45,45
4,1,95,True,44.0,0.0,5.800000000000001,95,0
4,1,95,False,50.0,0.20216301591232028,75.35000000000001,47,48
4,1,100,True,55.0,0.0,5.800000000000001,100,0
4,1,100,False,100.0,0.2233141951442966,74.60000000000001,50,50
4,2,5,True,53.0,0.0,5.800000000000001,5,0
4,2,5,False,56.0,0.0,5.800000000000001,5,0
4,2,10,True,52.0,0.0,5.800000000000001,10,0
4,2,10,False,42.0,0.0,5.800000000000001,10,0
4,2,15,True,59.0,0.0,5.800000000000001,15,0
4,2,15,False,57.0,0.0,5.800000000000001,15,0
4,2,20,True,49.0,0.0,5.800000000000001,20,0
4,2,20,False,60.0,0.0,5.800000000000001,20,0
4,2,25,True,57.0,0.0,5.800000000000001,25,0
4,2,25,False,98.0,0.07616390666943275,50.050000000000004,13,12
4,2,30,True,49.0,0.0,5.800000000000001,30,0
4,2,30,False,96.0,0.10773083242007289,90.85000000000001,15,15
4,2,35,True,49.0,0.0,5.800000000000001,35,0
4,2,35,False,98.0,0.13049892056162896,66.8,17,18
4,2,40,True,54.0,0.006791787127888014,,20,20
4,2,40,False,98.0,0.15653122179597162,72.95,20,20
4,2,45,True,56.0,0.009981794220427638,62.550000000000004,23,22
4,2,45,False,100.0,0.1723752554323587,117.9,23,22
4,2,50,True,60.0,0.00032677996494466114,,0,50
4,2,50,False,100.0,0.17634603216306527,127.10000000000001,25,25
4,2,55,True,55.0,5.837517061566831e-05,81.5,51,4
4,2,55,False,100.0,0.18542237534214848,82.0,27,28
4,2,60,True,51.0,0.0,5.800000000000001,60,0
4,2,60,False,100.0,0.1886395529197464,130.8,30,30
4,2,65,True,59.0,0.0,5.800000000000001,65,0
4,2,65,False,100.0,0.18909074941531512,110.75,33,32
4,2,70,True,47.0,0.0,5.800000000000001,70,0
4,2,70,False,100.0,0.1973223897388534,99.80000000000001,35,35
4,2,75,True,55.0,0.0,5.800000000000001,75,0
4,2,75,False,100.0,0.1979345649375702,97.35000000000001,38,37
4,2,80,True,50.0,0.0,5.800000000000001,80,0
4,2,80,False,100.0,0.2058499276404694,36.550000000000004,40,40
4,2,85,True,64.0,0.0,5.800000000000001,85,0
4,2,85,False,100.0,0.2079041175596824,87.85000000000001,42,43
4,2,90,True,52.0,0.0,5.800000000000001,90,0
4,2,90,False,100.0,0.21579986933484882,100.9,45,45
4,2,95,True,54.0,0.0,5.800000000000001,95,0
4,2,95,False,100.0,0.21261337860246668,169.75,47,48
4,2,100,True,62.0,0.0,5.800000000000001,100,0
4,2,100,False,100.0,0.2181870043978294,98.60000000000001,50,50
4,3,5,True,50.0,0.0,5.800000000000001,5,0
4,3,5,False,60.0,0.0,5.800000000000001,5,0
4,3,10,True,47.0,0.0,5.800000000000001,10,0
4,3,10,False,49.0,0.0,5.800000000000001,10,0
4,3,15,True,57.0,0.0,5.800000000000001,15,0
4,3,15,False,54.0,0.0,5.800000000000001,15,0
4,3,20,True,44.0,0.0,5.800000000000001,20,0
4,3,20,False,57.0,0.0,5.800000000000001,20,0
4,3,25,True,48.0,0.0,5.800000000000001,25,0
4,3,25,False,97.0,0.0758081774837777,52.6,13,12
4,3,30,True,57.0,0.0,5.800000000000001,30,0
4,3,30,False,97.0,0.10295743775765229,72.35000000000001,15,15
4,3,35,True,47.0,0.0006508761858988286,81.30000000000001,17,18
4,3,35,False,98.0,0.11622213418721244,62.7,18,17
4,3,40,True,56.0,0.010952899460126555,140.45000000000002,20,20
4,3,40,False,98.0,0.15255748802780092,81.25,20,20
4,3,45,True,57.0,0.004045703573009227,114.30000000000001,23,22
4,3,45,False,98.0,0.1637122017891075,113.0,22,23
4,3,50,True,53.0,0.0005542513269419912,113.65,9,41
4,3,50,False,95.0,0.16192858470223417,79.55000000000001,25,25
4,3,55,True,48.0,0.028218747150634677,129.55,27,28
4,3,55,False,100.0,0.19625633730706385,48.75,27,28
4,3,60,True,53.0,0.00803188552407902,122.55000000000001,30,30
4,3,60,False,100.0,0.19333207623683996,151.45000000000002,30,30
4,3,65,True,52.0,0.0715260140572912,195.35000000000002,32,33
4,3,65,False,50.0,0.06461418878031178,45.300000000000004,33,32
4,3,70,True,51.0,0.04245123449498186,241.10000000000002,35,35
4,3,70,False,39.0,0.0008024213417200524,,0,70
4,3,75,True,53.0,0.119780586210606,252.60000000000002,37,38
4,3,75,False,49.0,0.06467789184230678,,75,0
4,3,80,True,50.0,0.08467358809460764,199.25,40,40
4,3,80,False,89.0,0.201112117433417,,40,40
4,3,85,True,49.0,0.057288679815146716,187.25,43,42
4,3,85,False,96.0,0.207962457161759,321.75,43,42
4,3,90,True,63.0,0.032152978861301716,129.95000000000002,45,45
4,3,90,False,89.0,0.20801036911331686,95.15,45,45
4,3,95,True,53.0,0.12191653282026513,,47,48
4,3,95,False,100.0,0.23632220015379285,237.60000000000002,47,48
4,3,100,True,67.0,0.19444122000896402,,50,50
4,3,100,False,51.0,0.1717117563094056,304.15000000000003,50,50
4,4,5,True,62.0,0.0,5.800000000000001,5,0
4,4,5,False,54.0,0.0,5.800000000000001,5,0
4,4,10,True,52.0,0.0,5.800000000000001,10,0
4,4,10,False,52.0,0.0,5.800000000000001,10,0
4,4,15,True,48.0,0.0,5.800000000000001,15,0
4,4,15,False,56.0,0.0,5.800000000000001,15,0
4,4,20,True,54.0,0.0,5.800000000000001,20,0
4,4,20,False,57.0,0.0,5.800000000000001,20,0
4,4,25,True,57.0,0.0,5.800000000000001,25,0
4,4,25,False,97.0,0.07385638851658223,100.75,13,12
4,4,30,True,62.0,0.0,5.800000000000001,30,0
4,4,30,False,96.0,0.10769892452194262,57.050000000000004,15,15
4,4,35,True,55.0,0.0,5.800000000000001,35,0
4,4,35,False,96.0,0.13111738492845781,112.35000000000001,17,18
4,4,40,True,62.0,0.0,5.800000000000001,40,0
4,4,40,False,97.0,0.13498427552587033,99.95,20,20
4,4,45,True,53.0,0.0,5.800000000000001,45,0
4,4,45,False,93.0,0.1488493709552077,135.6,22,23
4,4,50,True,51.0,0.0,5.800000000000001,50,0
4,4,50,False,98.0,0.1990067629088901,59.25,25,25
4,4,55,True,48.0,0.0,5.800000000000001,55,0
4,4,55,False,100.0,0.17023420870183475,133.0,27,28
4,4,60,True,63.0,1.0963940951057461e-05,81.75,1,59
4,4,60,False,99.0,0.20207896746235993,35.45,30,30
4,4,65,True,61.0,3.6416642800002935e-05,,64,1
4,4,65,False,46.0,0.07128155783982112,60.800000000000004,32,33
4,4,70,True,51.0,0.0006928349615353827,183.05,14,56
4,4,70,False,48.0,0.028269780342934255,62.85,70,0
4,4,75,True,53.0,0.0012620369010086273,,0,75
4,4,75,False,41.0,0.17726909607325156,61.050000000000004,37,38
4,4,80,True,51.0,0.013537244080236353,224.8,38,42
4,4,80,False,51.0,0.04469864357283147,211.70000000000002,40,40
4,4,85,True,61.0,0.002823946853091221,65.25,0,85
4,4,85,False,50.0,0.07380929386819564,,42,43
4,4,90,True,54.0,0.0008058099520364683,15.9,4,86
4,4,90,False,74.0,0.17418638342765044,90.4,86,4
4,4,95,True,54.0,0.0016057435550115766,217.8,0,95
4,4,95,False,100.0,0.24405532058773713,99.15,47,48
4,4,100,True,42.0,0.19276758056112422,192.65,50,50
4,4,100,False,40.0,0.21526669163028628,53.150000000000006,50,50
4,5,5,True,49.0,0.0,5.800000000000001,5,0
4,5,5,False,55.0,0.0,5.800000000000001,5,0
4,5,10,True,50.0,0.0,5.800000000000001,10,0
4,5,10,False,51.0,0.0,5.800000000000001,10,0
4,5,15,True,55.0,0.0,5.800000000000001,15,0
4,5,15,False,47.0,0.0,5.800000000000001,15,0
4,5,20,True,57.0,0.0,5.800000000000001,20,0
4,5,20,False,53.0,0.0,5.800000000000001,20,0
4,5,25,True,49.0,0.0,5.800000000000001,25,0
4,5,25,False,97.0,0.08204230112966461,98.60000000000001,12,13
4,5,30,True,53.0,0.0,5.800000000000001,30,0
4,5,30,False,97.0,0.10185894825314781,58.1,15,15
4,5,35,True,54.0,0.0,5.800000000000001,35,0
4,5,35,False,94.0,0.1207982195650608,135.6,17,18
4,5,40,True,52.0,0.0,5.800000000000001,40,0
4,5,40,False,97.0,0.14171891546529403,88.85000000000001,20,20
4,5,45,True,63.0,0.0,5.800000000000001,45,0
4,5,45,False,100.0,0.161329723502219,101.80000000000001,22,23
4,5,50,True,60.0,2.52590623002165e-06,11.850000000000001,49,1
4,5,50,False,54.0,0.0016000036236196553,148.95000000000002,0,50
4,5,55,True,45.0,0.0012630772853320354,7.550000000000001,0,55
4,5,55,False,100.0,0.22172052568919795,233.55,27,28
4,5,60,True,49.0,0.008215591916010507,195.3,30,30
4,5,60,False,64.0,0.11795121504068479,50.050000000000004,0,60
4,5,65,True,55.0,0.0002201308443944431,174.8,46,19
4,5,65,False,87.0,0.21929543466286305,121.15,30,35
4,5,70,True,57.0,0.0035094110446834653,29.05,70,0
4,5,70,False,100.0,0.21905710211862367,59.650000000000006,35,35
4,5,75,True,59.0,0.019796371505002477,31.3,38,37
4,5,75,False,57.0,0.04902893716666348,48.95,73,2
4,5,80,True,54.0,0.007220471024917832,81.45,77,3
4,5,80,False,100.0,0.21429266672696373,175.65,40,40
4,5,85,True,58.0,0.020441643495933172,94.2,53,32
4,5,85,False,100.0,0.21564068410787718,103.80000000000001,42,43
4,5,90,True,52.0,0.0024529162575839328,79.65,39,51
4,5,90,False,100.0,0.23303942327316748,146.25,47,43
4,5,95,True,55.0,0.0008834663988384239,241.4,46,49
4,5,95,False,54.0,0.14667217663705576,68.10000000000001,53,42
4,5,100,True,51.0,0.1145690140686618,132.9,65,35
4,5,100,False,50.0,0.21325061709607526,290.3,50,50
4,6,5,True,53.0,0.0,5.800000000000001,5,0
4,6,5,False,59.0,0.0,5.800000000000001,5,0
4,6,10,True,53.0,0.0,5.800000000000001,10,0
4,6,10,False,50.0,0.0,5.800000000000001,10,0
4,6,15,True,55.0,0.0,5.800000000000001,15,0
4,6,15,False,53.0,0.0,5.800000000000001,15,0
4,6,20,True,49.0,0.0,5.800000000000001,20,0
4,6,20,False,53.0,0.0,5.800000000000001,20,0
4,6,25,True,60.0,0.0,5.800000000000001,25,0
4,6,25,False,96.0,0.07898837746881021,84.4,12,13
4,6,30,True,64.0,0.0,5.800000000000001,30,0
4,6,30,False,99.0,0.1098166613450602,141.5,15,15
4,6,35,True,50.0,0.0,5.800000000000001,35,0
4,6,35,False,97.0,0.12002026977866365,86.75,17,18
4,6,40,True,53.0,0.0,5.800000000000001,40,0
4,6,40,False,100.0,0.1549467975764536,89.65,20,20
4,6,45,True,49.0,2.1714462832967934e-05,54.800000000000004,29,16
4,6,45,False,100.0,0.16687393287247107,110.80000000000001,22,23
4,6,50,True,55.0,4.051310086679409e-05,33.45,41,9
4,6,50,False,100.0,0.18482751064987588,131.95000000000002,25,25
4,6,55,True,60.0,0.0012600062058977777,,14,41
4,6,55,False,59.0,0.05581014127439316,82.0,54,1
4,6,60,True,57.0,0.0001942325463208479,309.55,0,60
4,6,60,False,100.0,0.20381830658756417,106.30000000000001,30,30
4,6,65,True,69.0,0.01341641251008957,214.60000000000002,34,31
4,6,65,False,46.0,0.0795631016340397,69.3,64,1
4,6,70,True,57.0,0.0011087607038365267,30.75,68,2
4,6,70,False,46.0,0.04220082188250125,39.7,70,0
4,6,75,True,65.0,0.09930970570849011,,37,38
4,6,75,False,100.0,0.2156277940124375,90.85000000000001,38,37
4,6,80,True,57.0,0.06633484047723369,84.60000000000001,40,40
4,6,80,False,60.0,0.1854989082962543,46.050000000000004,40,40
4,6,85,True,46.0,0.07587128317763199,,43,42
4,6,85,False,100.0,0.23970734420425477,161.20000000000002,42,43
4,6,90,True,56.0,0.12033264229094985,53.550000000000004,45,45
4,6,90,False,100.0,0.2463992856536659,119.7,45,45
4,6,95,True,65.0,0.011006460933382848,169.10000000000002,48,47
4,6,95,False,100.0,0.2219564791179186,169.15,48,47
4,6,100,True,49.0,0.06792867920361038,175.0,33,67
4,6,100,False,48.0,0.18092722785172566,79.85000000000001,50,50
4,7,5,True,50.0,0.0,5.800000000000001,5,0
4,7,5,False,52.0,0.0,5.800000000000001,5,0
4,7,10,True,54.0,0.0,5.800000000000001,10,0
4,7,10,False,53.0,0.0,5.800000000000001,10,0
4,7,15,True,52.0,0.0,5.800000000000001,15,0
4,7,15,False,43.0,0.0,5.800000000000001,15,0
4,7,20,True,57.0,0.0,5.800000000000001,20,0
4,7,20,False,54.0,0.0,5.800000000000001,20,0
4,7,25,True,56.0,0.0,5.800000000000001,25,0
4,7,25,False,98.0,0.07700864950256728,97.7,13,12
4,7,30,True,52.0,0.0,5.800000000000001,30,0
4,7,30,False,99.0,0.10515165269083261,136.1,15,15
4,7,35,True,51.0,0.0,5.800000000000001,35,0
4,7,35,False,99.0,0.11533163835710497,194.45000000000002,17,18
4,7,40,True,55.0,0.00021788575167805993,52.95,20,20
4,7,40,False,99.0,0.1579512263615295,70.8,20,20
4,7,45,True,60.0,0.002319247397859394,320.40000000000003,28,17
4,7,45,False,47.0,0.06535566356862028,,22,23
4,7,50,True,56.0,0.026621507164130934,296.1,25,25
4,7,50,False,100.0,0.1816139514904736,123.9,25,25
4,7,55,True,52.0,0.009456280240714189,305.8,28,27
4,7,55,False,88.0,0.19078084501576217,61.0,27,28
4,7,60,True,64.0,0.11162409348394363,334.1,30,30
4,7,60,False,99.0,0.1740091423189613,97.65,30,30
4,7,65,True,50.0,0.0,5.800000000000001,65,0
4,7,65,False,50.0,0.030461615182742294,66.75,33,32
4,7,70,True,83.0,0.12990092857641258,,35,35
4,7,70,False,47.0,0.12382745589592961,,36,34
4,7,75,True,68.0,0.14257850983381928,232.3,38,37
4,7,75,False,100.0,0.21074262770015462,133.6,37,38
4,7,80,True,80.0,0.1310079220694879,160.60000000000002,41,39
4,7,80,False,82.0,0.22115436661409418,70.95,40,40
4,7,85,True,73.0,0.0991961558806982,288.40000000000003,47,38
4,7,85,False,94.0,0.23337306060658689,,42,43
4,7,90,True,64.0,0.07353323382120291,,45,45
4,7,90,False,100.0,0.2382999989292567,97.9,45,45
4,7,95,True,52.0,0.09980729815821422,68.10000000000001,47,48
4,7,95,False,99.0,0.21812363634077922,,47,48
4,7,100,True,42.0,0.01613139475990699,149.05,3,97
4,7,100,False,51.0,0.08257601658603701,147.25,96,4
4,8,5,True,52.0,0.0,5.800000000000001,5,0
4,8,5,False,48.0,0.0,5.800000000000001,5,0
4,8,10,True,58.0,0.0,5.800000000000001,10,0
4,8,10,False,54.0,0.0,5.800000000000001,10,0
4,8,15,True,53.0,0.0,5.800000000000001,15,0
4,8,15,False,50.0,0.0,5.800000000000001,15,0
4,8,20,True,49.0,0.0,5.800000000000001,20,0
4,8,20,False,53.0,0.0,5.800000000000001,20,0
4,8,25,True,56.0,0.0,5.800000000000001,25,0
4,8,25,False,98.0,0.07713615133586287,91.55000000000001,13,12
4,8,30,True,49.0,0.0,5.800000000000001,30,0
4,8,30,False,99.0,0.10450690865015741,46.7,15,15
4,8,35,True,50.0,0.0,5.800000000000001,35,0
4,8,35,False,98.0,0.11624320913219476,64.60000000000001,18,17
4,8,40,True,46.0,0.0,5.800000000000001,40,0
4,8,40,False,99.0,0.13571720944385657,148.15,20,20
4,8,45,True,56.0,7.128475975003864e-05,,27,18
4,8,45,False,100.0,0.15618550478458143,163.4,22,23
4,8,50,True,43.0,0.0005955821944627121,,25,25
4,8,50,False,100.0,0.17921566097548444,190.70000000000002,25,25
4,8,55,True,56.0,0.004221070968033215,81.05000000000001,32,23
4,8,55,False,100.0,0.1762698293988883,141.35,27,28
4,8,60,True,70.0,0.10450440580948897,,30,30
4,8,60,False,99.0,0.1767051886425786,91.9,30,30
4,8,65,True,81.0,0.12535134290705752,102.80000000000001,33,32
4,8,65,False,96.0,0.18228511089449947,136.65,32,33
4,8,70,True,89.0,0.1585564863580781,,35,35
4,8,70,False,100.0,0.2359446476065607,161.9,35,35
4,8,75,True,76.0,0.14058023392789443,222.8,38,37
4,8,75,False,98.0,0.20964559824934043,68.95,37,38
4,8,80,True,87.0,0.14806520419706937,199.10000000000002,41,39
4,8,80,False,46.0,0.04138401074124223,,62,18
4,8,85,True,84.0,0.16304567193083266,181.70000000000002,42,43
4,8,85,False,99.0,0.21917666041820688,114.4,42,43
4,8,90,True,76.0,0.14249272392458898,211.55,46,44
4,8,90,False,98.0,0.21822092932169476,95.60000000000001,48,42
4,8,95,True,63.0,0.03946150159213228,,44,51
4,8,95,False,93.0,0.23797973796215313,280.6,50,45
4,8,100,True,53.0,0.0030786612857091893,,100,0
4,8,100,False,49.0,0.04868622035017455,,75,25
4,9,5,True,59.0,0.0,5.800000000000001,5,0
4,9,5,False,54.0,0.0,5.800000000000001,5,0
4,9,10,True,58.0,0.0,5.800000000000001,10,0
4,9,10,False,57.0,0.0,5.800000000000001,10,0
4,9,15,True,62.0,0.0,5.800000000000001,15,0
4,9,15,False,54.0,0.0,5.800000000000001,15,0
4,9,20,True,51.0,0.0,5.800000000000001,20,0
4,9,20,False,57.0,0.0002625997032904824,97.30000000000001,5,15
4,9,25,True,47.0,0.0,5.800000000000001,25,0
4,9,25,False,99.0,0.0783065670470636,72.35000000000001,12,13
4,9,30,True,62.0,0.0,5.800000000000001,30,0
4,9,30,False,100.0,0.10740088529632977,166.4,15,15
4,9,35,True,44.0,0.0,5.800000000000001,35,0
4,9,35,False,100.0,0.12225620952252357,125.0,17,18
4,9,40,True,53.0,0.0,5.800000000000001,40,0
4,9,40,False,98.0,0.13646498831730286,91.10000000000001,20,20
4,9,45,True,53.0,0.00012105149468509591,,42,3
4,9,45,False,100.0,0.14932074753829772,135.6,22,23
4,9,50,True,53.0,0.00822650846825784,52.550000000000004,26,24
4,9,50,False,98.0,0.1755480710623078,96.15,25,25
4,9,55,True,64.0,0.06834525052683578,,28,27
4,9,55,False,98.0,0.16814129568018174,62.050000000000004,27,28
4,9,60,True,90.0,0.14325911621850657,273.2,30,30
4,9,60,False,54.0,0.006284097058969213,78.55000000000001,0,60
4,9,65,True,87.0,0.14517922588734683,207.25,33,32
4,9,65,False,97.0,0.1824741281200909,100.30000000000001,32,33
4,9,70,True,87.0,0.15259285602358458,136.55,35,35
4,9,70,False,97.0,0.1787348034378685,85.75,35,35
4,9,75,True,86.0,0.15721373395305904,191.75,38,37
4,9,75,False,96.0,0.19224280712142977,114.35000000000001,37,38
4,9,80,True,90.0,0.16168463828834018,206.20000000000002,40,40
4,9,80,False,100.0,0.2058971779592532,,40,40
4,9,85,True,86.0,0.1477227733878334,162.8,45,40
4,9,85,False,97.0,0.2085203677702351,141.65,42,43
4,9,90,True,79.0,0.13954618462967153,176.20000000000002,47,43
4,9,90,False,100.0,0.23034800502490047,132.6,45,45
4,9,95,True,78.0,0.15978071908254607,,48,47
4,9,95,False,99.0,0.2210265464382624,109.5,48,47
4,9,100,True,41.0,0.040038266444476604,323.75,28,72
4,9,100,False,54.0,0.11189487802287383,134.0,50,50
4,10,5,True,51.0,0.0,5.800000000000001,5,0
4,10,5,False,56.0,0.0,5.800000000000001,5,0
4,10,10,True,57.0,0.0,5.800000000000001,10,0
4,10,10,False,52.0,0.0,5.800000000000001,10,0
4,10,15,True,57.0,0.0,5.800000000000001,15,0
4,10,15,False,50.0,0.0,5.800000000000001,15,0
4,10,20,True,63.0,0.0,5.800000000000001,20,0
4,10,20,False,56.0,0.00031206329416884283,97.30000000000001,6,14
4,10,25,True,42.0,0.0,5.800000000000001,25,0
4,10,25,False,99.0,0.07848420625919675,108.45,12,13
4,10,30,True,54.0,0.0,5.800000000000001,30,0
4,10,30,False,99.0,0.10240284280426193,166.35000000000002,15,15
4,10,35,True,61.0,0.0,5.800000000000001,35,0
4,10,35,False,99.0,0.11679763160759815,166.20000000000002,17,18
4,10,40,True,54.0,0.0,5.800000000000001,40,0
4,10,40,False,100.0,0.18206418782020076,73.8,20,20
4,10,45,True,50.0,8.101409337964404e-05,,34,11
4,10,45,False,100.0,0.18737121926288158,128.25,22,23
4,10,50,True,82.0,0.11061214650304567,164.85000000000002,25,25
4,10,50,False,54.0,0.0293958052064973,,50,0
4,10,55,True,88.0,0.13050681955927798,11.15,28,27
4,10,55,False,61.0,0.007227658940668026,,0,55
4,10,60,True,48.0,0.021601496077440475,181.05,38,22
4,10,60,False,95.0,0.18173778564399481,31.400000000000002,30,30
4,10,65,True,89.0,0.14818645086085563,,33,32
4,10,65,False,96.0,0.18344578921707794,137.20000000000002,32,33
4,10,70,True,78.0,0.14713118060601857,2.8000000000000003,35,35
4,10,70,False,98.0,0.18971402941743945,124.60000000000001,35,35
4,10,75,True,85.0,0.12486935913968833,299.90000000000003,38,37
4,10,75,False,98.0,0.18904773452713058,140.95000000000002,37,38
4,10,80,True,92.0,0.1556279999819244,170.35000000000002,40,40
4,10,80,False,98.0,0.20280313315588863,129.75,40,40
4,10,85,True,82.0,0.15222774492452681,187.35000000000002,43,42
4,10,85,False,100.0,0.23313241144772684,264.7,42,43
4,10,90,True,85.0,0.16667748645312597,24.0,45,45
4,10,90,False,47.0,0.14435932364460416,,72,18
4,10,95,True,40.0,0.07398072281699357,,74,21
4,10,95,False,100.0,0.2293156188234015,163.70000000000002,47,48
4,10,100,True,47.0,0.007435968449842987,82.4,77,23
4,10,100,False,52.0,0.03421174557122049,219.55,87,13
5,0,5,True,52.0,0.0,5.800000000000001,5,0
5,0,5,False,53.0,0.0,5.800000000000001,5,0
5,0,10,True,52.0,0.0,5.800000000000001,10,0
5,0,10,False,56.0,0.0,5.800000000000001,10,0
5,0,15,True,57.0,0.0,5.800000000000001,15,0
5,0,15,False,62.0,0.0,5.800000000000001,15,0
5,0,20,True,50.0,0.0,5.800000000000001,20,0
5,0,20,False,65.0,0.0,5.800000000000001,20,0
5,0,25,True,47.0,0.0,5.800000000000001,25,0
5,0,25,False,98.0,0.07740622455267802,159.0,12,13
5,0,30,True,49.0,0.0,5.800000000000001,30,0
5,0,30,False,98.0,0.11078542591160219,,15,15
5,0,35,True,55.0,0.0,5.800000000000001,35,0
5,0,35,False,98.0,0.12287460586039844,131.3,17,18
5,0,40,True,57.0,0.0,5.800000000000001,40,0
5,0,40,False,97.0,0.14593990048344635,207.65,20,20
5,0,45,True,58.0,0.0,5.800000000000001,45,0
5,0,45,False,97.0,0.15161986009226502,115.60000000000001,22,23
5,0,50,True,61.0,0.0,5.800000000000001,50,0
5,0,50,False,98.0,0.1788259179304764,96.30000000000001,25,25
5,0,55,True,45.0,0.035547736415533215,151.70000000000002,1,54
5,0,55,False,100.0,0.19853348751587027,123.9,27,28
5,0,60,True,55.0,0.003759974060409786,,30,30
5,0,60,False,98.0,0.21367107627713455,58.550000000000004,30,30
5,0,65,True,55.0,7.852515914834001e-05,85.10000000000001,65,0
5,0,65,False,98.0,0.1916887049325489,131.1,32,33
5,0,70,True,57.0,0.0008116603457454468,44.95,6,64
5,0,70,False,98.0,0.22857566273792554,152.45000000000002,35,35
5,0,75,True,51.0,0.00017608757525325005,131.0,1,74
5,0,75,False,51.0,0.0035541088779932908,,0,75
5,0,80,True,58.0,0.0005614876217796867,132.20000000000002,38,42
5,0,80,False,99.0,0.20715165824892176,144.20000000000002,40,40
5,0,85,True,53.0,0.0023908967378476133,127.95,84,1
5,0,85,False,98.0,0.2282196299323901,128.15,42,43
5,0,90,True,51.0,0.0031021299858108925,91.80000000000001,8,82
5,0,90,False,97.0,0.22967649012032168,88.75,45,45
5,0,95,True,51.0,0.0036874522916316346,204.20000000000002,47,48
5,0,95,False,57.0,0.002746713229548584,,0,95
5,0,100,True,56.0,0.057625725817435365,233.8,78,22
5,0,100,False,86.0,0.23925952603607642,273.3,50,50
5,1,5,True,53.0,0.0,5.800000000000001,5,0
5,1,5,False,51.0,0.0,5.800000000000001,5,0
5,1,10,True,54.0,0.0,5.800000000000001,10,0
5,1,10,False,47.0,0.0,5.800000000000001,10,0
5,1,15,True,61.0,0.0,5.800000000000001,15,0
5,1,15,False,61.0,0.0,5.800000000000001,15,0
5,1,20,True,55.0,0.0,5.800000000000001,20,0
5,1,20,False,57.0,0.0,5.800000000000001,20,0
5,1,25,True,57.0,0.0,5.800000000000001,25,0
5,1,25,False,98.0,0.07525952192197277,78.7,12,13
5,1,30,True,50.0,0.0,5.800000000000001,30,0
5,1,30,False,95.0,0.10877571203572324,103.7,15,15
5,1,35,True,58.0,0.0,5.800000000000001,35,0
5,1,35,False,97.0,0.11937995611222228,101.30000000000001,17,18
5,1,40,True,47.0,0.0,5.800000000000001,40,0
5,1,40,False,97.0,0.1478169616162833,156.25,20,20
5,1,45,True,48.0,0.0,5.800000000000001,45,0
5,1,45,False,50.0,0.1561655953095829,97.5,22,23
5,1,50,True,56.0,0.0,5.800000000000001,50,0
5,1,50,False,52.0,0.15793928262061144,106.55000000000001,29,21
5,1,55,True,61.0,0.0,5.800000000000001,55,0
5,1,55,False,45.0,0.16656398852469398,133.3,33,22
5,1,60,True,47.0,0.0,5.800000000000001,60,0
5,1,60,False,51.0,0.16019830465626966,136.75,39,21
5,1,65,True,56.0,0.0,5.800000000000001,65,0
5,1,65,False,47.0,0.16106727685785172,62.400000000000006,39,26
5,1,70,True,52.0,0.0,5.800000000000001,70,0
5,1,70,False,43.0,0.16410619175563546,86.45,40,30
5,1,75,True,55.0,0.0,5.800000000000001,75,0
5,1,75,False,51.0,0.17573974250362123,168.60000000000002,44,31
5,1,80,True,52.0,0.0,5.800000000000001,80,0
5,1,80,False,56.0,0.18182239022553298,92.25,41,39
5,1,85,True,60.0,0.0,5.800000000000001,85,0
5,1,85,False,51.0,0.18818452142153064,69.75,43,42
5,1,90,True,52.0,0.0,5.800000000000001,90,0
5,1,90,False,44.0,0.20145926188312552,126.80000000000001,45,45
5,1,95,True,57.0,0.0,5.800000000000001,95,0
5,1,95,False,52.0,0.1977003578289634,133.75,47,48
5,1,100,True,59.0,0.0,5.800000000000001,100,0
5,1,100,False,48.0,0.21492258713640378,205.4,50,50
5,2,5,True,49.0,0.0,5.800000000000001,5,0
5,2,5,False,50.0,0.0,5.800000000000001,5,0
5,2,10,True,41.0,0.0,5.800000000000001,10,0
5,2,10,False,59.0,0.0,5.800000000000001,10,0
5,2,15,True,45.0,0.0,5.800000000000001,15,0
5,2,15,False,51.0,0.0,5.800000000000001,15,0
5,2,20,True,52.0,0.0,5.800000000000001,20,0
5,2,20,False,54.0,0.0,5.800000000000001,20,0
5,2,25,True,41.0,0.0,5.800000000000001,25,0
5,2,25,False,98.0,0.0773478281141181,98.35000000000001,13,12
5,2,30,True,56.0,0.0,5.800000000000001,30,0
5,2,30,False,97.0,0.11058247188303573,84.2,15,15
5,2,35,True,52.0,0.0,5.800000000000001,35,0
5,2,35,False,98.0,0.12903212835865385,119.60000000000001,17,18
5,2,40,True,53.0,0.01678281374203189,,20,20
5,2,40,False,99.0,0.1572127445555788,78.60000000000001,20,20
5,2,45,True,56.0,0.004775666057226651,,23,22
5,2,45,False,99.0,0.1686619907212703,119.30000000000001,22,23
5,2,50,True,46.0,0.00031651133271337324,13.5,16,34
5,2,50,False,100.0,0.17909771997070562,131.65,25,25
5,2,55,True,52.0,0.0,5.800000000000001,55,0
5,2,55,False,99.0,0.18133908289962347,95.15,27,28
5,2,60,True,60.0,0.0,5.800000000000001,60,0
5,2,60,False,100.0,0.19170311197102508,125.65,30,30
5,2,65,True,56.0,0.0,5.800000000000001,65,0
5,2,65,False,100.0,0.1884923703750639,88.55000000000001,32,33
5,2,70,True,58.0,0.0,5.800000000000001,70,0
5,2,70,False,100.0,0.19991041782694863,168.20000000000002,35,35
5,2,75,True,52.0,0.0,5.800000000000001,75,0
5,2,75,False,100.0,0.19974905599909415,100.7,37,38
5,2,80,True,44.0,0.0,5.800000000000001,80,0
5,2,80,False,100.0,0.20673673142517185,41.75,40,40
5,2,85,True,52.0,0.0,5.800000000000001,85,0
5,2,85,False,100.0,0.20687880865108552,132.95000000000002,42,43
5,2,90,True,52.0,0.0,5.800000000000001,90,0
5,2,90,False,100.0,0.2152656604672238,93.45,45,45
5,2,95,True,59.0,0.0,5.800000000000001,95,0
5,2,95,False,100.0,0.21249761924163443,98.2,47,48
5,2,100,True,58.0,0.0,5.800000000000001,100,0
5,2,100,False,100.0,0.21692726822514274,101.4,50,50
5,3,5,True,55.0,0.0,5.800000000000001,5,0
5,3,5,False,55.0,0.0,5.800000000000001,5,0
5,3,10,True,57.0,0.0,5.800000000000001,10,0
5,3,10,False,59.0,0.0,5.800000000000001,10,0
5,3,15,True,60.0,0.0,5.800000000000001,15,0
5,3,15,False,56.0,0.0,5.800000000000001,15,0
5,3,20,True,52.0,0.0,5.800000000000001,20,0
5,3,20,False,55.0,0.0,5.800000000000001,20,0
5,3,25,True,54.0,0.0,5.800000000000001,25,0
5,3,25,False,98.0,0.07589112531772202,181.15,13,12
5,3,30,True,56.0,0.0,5.800000000000001,30,0
5,3,30,False,97.0,0.10573873138846576,83.05000000000001,15,15
5,3,35,True,51.0,0.0005450874479622217,195.95000000000002,17,18
5,3,35,False,96.0,0.1207710695690288,193.95000000000002,18,17
5,3,40,True,54.0,0.0037125469332498066,134.35,20,20
5,3,40,False,95.0,0.13680751827861526,144.70000000000002,20,20
5,3,45,True,56.0,0.0035467798249620634,120.05000000000001,22,23
5,3,45,False,98.0,0.1514639299679347,67.35000000000001,23,22
5,3,50,True,51.0,0.0032929254369983268,130.5,25,25
5,3,50,False,100.0,0.23994103277193413,70.45,25,25
5,3,55,True,46.0,0.030822591422617406,155.65,28,27
5,3,55,False,52.0,0.008548989299872854,175.3,1,54
5,3,60,True,51.0,0.043807515662675184,118.95,30,30
5,3,60,False,50.0,0.03160137944922976,30.700000000000003,59,1
5,3,65,True,56.0,0.039599372262212953,,33,32
5,3,65,False,60.0,0.042519453259141284,57.1,65,0
5,3,70,True,51.0,0.0007083011544782734,201.35000000000002,70,0
5,3,70,False,96.0,0.20819416120944667,127.60000000000001,70,0
5,3,75,True,56.0,0.030436221947261834,,37,38
5,3,75,False,82.0,0.16383142760641398,94.4,38,37
5,3,80,True,47.0,0.0020440783297739624,,1,79
5,3,80,False,50.0,0.03971819183895066,116.45,40,40
5,3,85,True,58.0,0.015582606035004524,209.25,31,54
5,3,85,False,95.0,0.21359754172245748,84.2,43,42
5,3,90,True,54.0,0.047980337090717314,94.85000000000001,80,10
5,3,90,False,100.0,0.21950883710136412,,45,45
5,3,95,True,53.0,0.07972224657912114,119.45,48,47
5,3,95,False,99.0,0.21757125740464653,103.85000000000001,47,48
5,3,100,True,48.0,0.1839979139141428,233.25,50,50
5,3,100,False,48.0,0.16810066547587182,,50,50
5,4,5,True,50.0,0.0,5.800000000000001,5,0
5,4,5,False,46.0,0.0,5.800000000000001,5,0
5,4,10,True,49.0,0.0,5.800000000000001,10,0
5,4,10,False,60.0,0.0,5.800000000000001,10,0
5,4,15,True,49.0,0.0,5.800000000000001,15,0
5,4,15,False,64.0,0.0,5.800000000000001,15,0
5,4,20,True,57.0,0.0,5.800000000000001,20,0
5,4,20,False,55.0,0.0,5.800000000000001,20,0
5,4,25,True,52.0,0.0,5.800000000000001,25,0
5,4,25,False,98.0,0.07473503938997986,101.35000000000001,12,13
5,4,30,True,59.0,0.0,5.800000000000001,30,0
5,4,30,False,98.0,0.12483869441198517,147.05,15,15
5,4,35,True,52.0,0.0,5.800000000000001,35,0
5,4,35,False,99.0,0.13419255086072332,,17,18
5,4,40,True,54.0,0.0,5.800000000000001,40,0
5,4,40,False,93.0,0.14436848875129324,68.3,20,20
5,4,45,True,56.0,0.0,5.800000000000001,45,0
5,4,45,False,97.0,0.1481453891538726,81.2,22,23
5,4,50,True,50.0,0.0,5.800000000000001,50,0
5,4,50,False,99.0,0.16942365209227286,84.10000000000001,25,25
5,4,55,True,53.0,0.0,5.800000000000001,55,0
5,4,55,False,99.0,0.21014618979477137,99.60000000000001,27,28
5,4,60,True,54.0,0.00038202192080933993,,39,21
5,4,60,False,99.0,0.20537961325059165,138.55,30,30
5,4,65,True,44.0,0.0006525721342371658,31.35,18,47
5,4,65,False,84.0,0.18867522993160651,73.2,1,64
5,4,70,True,61.0,0.0041958279389441204,,3,67
5,4,70,False,100.0,0.2149057833612727,49.7,35,35
5,4,75,True,56.0,0.009604467410627305,51.25,72,3
5,4,75,False,63.0,0.10811744454051624,33.4,0,75
5,4,80,True,57.0,0.0009563459310208789,93.05000000000001,80,0
5,4,80,False,54.0,0.07477380957349762,106.80000000000001,0,80
5,4,85,True,63.0,0.04081339052727105,128.25,44,41
5,4,85,False,64.0,0.19483459789819552,128.35,47,38
5,4,90,True,55.0,0.009237768232485472,188.75,42,48
5,4,90,False,57.0,0.07001568888603475,54.1,90,0
5,4,95,True,62.0,0.0075334167535612085,214.9,46,49
5,4,95,False,99.0,0.21398016168600514,75.85000000000001,47,48
5,4,100,True,44.0,0.16616384772185727,212.05,50,50
5,4,100,False,49.0,0.22067597518422372,101.05000000000001,50,50
5,5,5,True,53.0,0.0,5.800000000000001,5,0
5,5,5,False,52.0,0.0,5.800000000000001,5,0
5,5,10,True,56.0,0.0,5.800000000000001,10,0
5,5,10,False,52.0,0.0,5.800000000000001,10,0
5,5,15,True,59.0,0.0,5.800000000000001,15,0
5,5,15,False,52.0,0.0,5.800000000000001,15,0
5,5,20,True,53.0,0.0,5.800000000000001,20,0
5,5,20,False,46.0,0.0,5.800000000000001,20,0
5,5,25,True,57.0,0.0,5.800000000000001,25,0
5,5,25,False,98.0,0.07651425787880953,86.5,12,13
5,5,30,True,53.0,0.0,5.800000000000001,30,0
5,5,30,False,95.0,0.11063467165115545,98.4,15,15
5,5,35,True,51.0,0.0,5.800000000000001,35,0
5,5,35,False,98.0,0.12773200090801878,92.0,17,18
5,5,40,True,48.0,0.0,5.800000000000001,40,0
5,5,40,False,99.0,0.14242668929915966,164.8,20,20
5,5,45,True,52.0,0.0,5.800000000000001,45,0
5,5,45,False,97.0,0.15238726547351406,125.35000000000001,22,23
5,5,50,True,58.0,0.00021136675896351817,56.900000000000006,49,1
5,5,50,False,45.0,0.0492625144819785,50.75,50,0
5,5,55,True,49.0,0.001582543675088357,303.5,17,38
5,5,55,False,94.0,0.18487570299275569,102.15,27,28
5,5,60,True,56.0,8.571072711104006e-05,82.9,0,60
5,5,60,False,52.0,0.001553905490517243,86.80000000000001,0,60
5,5,65,True,58.0,0.025663547212371723,81.85000000000001,33,32
5,5,65,False,66.0,0.13096054369638593,88.25,0,65
5,5,70,True,60.0,0.01153038622015388,56.2,17,53
5,5,70,False,100.0,0.2072504519494875,201.4,35,35
5,5,75,True,46.0,0.033986026502187995,8.85,5,70
5,5,75,False,100.0,0.21120035542835308,76.80000000000001,37,38
5,5,80,True,52.0,0.03239231772742377,,40,40
5,5,80,False,93.0,0.23660321417675267,,40,40
5,5,85,True,54.0,0.010379831350019188,194.85000000000002,43,42
5,5,85,False,100.0,0.22673991678060823,107.05000000000001,42,43
5,5,90,True,53.0,0.0022076851597932733,291.85,51,39
5,5,90,False,99.0,0.22735159520371137,54.150000000000006,46,44
5,5,95,True,55.0,0.000694517248845695,82.45,0,95
5,5,95,False,49.0,0.1628509912009605,85.25,49,46
5,5,100,True,57.0,0.11205478636825963,112.25,59,41
5,5,100,False,54.0,0.2217842757531301,120.7,50,50
5,6,5,True,55.0,0.0,5.800000000000001,5,0
5,6,5,False,51.0,0.0,5.800000000000001,5,0
5,6,10,True,63.0,0.0,5.800000000000001,10,0
5,6,10,False,58.0,0.0,5.800000000000001,10,0
5,6,15,True,47.0,0.0,5.800000000000001,15,0
5,6,15,False,51.0,0.0,5.800000000000001,15,0
5,6,20,True,50.0,0.0,5.800000000000001,20,0
5,6,20,False,53.0,0.0,5.800000000000001,20,0
5,6,25,True,55.0,0.0,5.800000000000001,25,0
5,6,25,False,97.0,0.07866780056764644,86.85000000000001,12,13
5,6,30,True,53.0,0.0,5.800000000000001,30,0
5,6,30,False,97.0,0.10683319274893927,139.20000000000002,15,15
5,6,35,True,54.0,0.0,5.800000000000001,35,0
5,6,35,False,98.0,0.12348883018779143,84.10000000000001,17,18
5,6,40,True,56.0,0.0,5.800000000000001,40,0
5,6,40,False,100.0,0.14490319380642291,87.7,20,20
5,6,45,True,53.0,4.037916043780085e-05,12.700000000000001,19,26
5,6,45,False,100.0,0.16368137125658042,115.25,22,23
5,6,50,True,47.0,1.2522064751311275e-05,46.300000000000004,48,2
5,6,50,False,100.0,0.1988744235994385,119.45,25,25
5,6,55,True,53.0,0.020063412508661706,31.85,27,28
5,6,55,False,100.0,0.19718316715661885,106.45,28,27
5,6,60,True,62.0,0.018453916286265047,24.450000000000003,30,30
5,6,60,False,99.0,0.24827755595941783,295.45,30,30
5,6,65,True,60.0,0.06421773658244928,177.20000000000002,32,33
5,6,65,False,100.0,0.20396082838133744,71.25,33,32
5,6,70,True,57.0,0.08789785524461155,52.25,35,35
5,6,70,False,100.0,0.24402723794961373,,35,35
5,6,75,True,65.0,0.09664708553920494,46.7,38,37
5,6,75,False,100.0,0.21676550901210226,54.45,37,38
5,6,80,True,65.0,0.11691756902313222,109.95,40,40
5,6,80,False,58.0,0.0013754028511635183,233.15,0,80
5,6,85,True,66.0,0.08065344300706785,,43,42
5,6,85,False,100.0,0.24407749323128683,42.400000000000006,43,42
5,6,90,True,55.0,0.02885606428114518,231.0,45,45
5,6,90,False,100.0,0.23743705746857063,131.65,45,45
5,6,95,True,53.0,0.020086874304278367,108.9,48,47
5,6,95,False,100.0,0.24193443153739283,164.35000000000002,47,48
5,6,100,True,45.0,0.09970834571477928,121.9,47,53
5,6,100,False,43.0,0.18275183708779008,208.20000000000002,50,50
5,7,5,True,57.0,0.0,5.800000000000001,5,0
5,7,5,False,43.0,0.0,5.800000000000001,5,0
5,7,10,True,52.0,0.0,5.800000000000001,10,0
5,7,10,False,53.0,0.0,5.800000000000001,10,0
5,7,15,True,56.0,0.0,5.800000000000001,15,0
5,7,15,False,47.0,0.0,5.800000000000001,15,0
5,7,20,True,60.0,0.0,5.800000000000001,20,0
5,7,20,False,56.0,0.0,5.800000000000001,20,0
5,7,25,True,61.0,0.0,5.800000000000001,25,0
5,7,25,False,96.0,0.07621784874015304,39.400000000000006,12,13
5,7,30,True,61.0,0.0,5.800000000000001,30,0
5,7,30,False,99.0,0.11708577503347412,71.55,15,15
5,7,35,True,54.0,0.0,5.800000000000001,35,0
5,7,35,False,97.0,0.12662681849548424,176.05,17,18
5,7,40,True,55.0,2.8773822023678056e-05,55.45,34,6
5,7,40,False,100.0,0.1556597719114964,132.25,20,20
5,7,45,True,51.0,0.0018480010660492968,28.450000000000003,45,0
5,7,45,False,89.0,0.17183022169484652,92.30000000000001,22,23
5,7,50,True,52.0,0.0003706913010320947,183.70000000000002,0,50
5,7,50,False,48.0,0.0020443699765018072,172.70000000000002,0,50
5,7,55,True,51.0,0.0003721380391470645,30.55,37,18
5,7,55,False,93.0,0.2426011625889978,93.65,27,28
5,7,60,True,54.0,0.004202054266338887,119.85000000000001,30,30
5,7,60,False,55.0,0.12104774013088422,55.25,10,50
5,7,65,True,48.0,0.0016764768433282686,,9,56
5,7,65,False,62.0,0.00546643809013958,,0,65
5,7,70,True,56.0,0.002081871956521094,,30,40
5,7,70,False,97.0,0.18810776217450964,,35,35
5,7,75,True,74.0,0.15451865591640218,248.9,38,37
5,7,75,False,57.0,0.002597985149160313,171.05,0,75
5,7,80,True,76.0,0.1404895402993265,,41,39
5,7,80,False,42.0,0.0686760580013874,228.10000000000002,40,40
5,7,85,True,75.0,0.09978977017860997,,43,42
5,7,85,False,56.0,0.02447118351307958,156.05,85,0
5,7,90,True,60.0,0.09724396946431471,158.95000000000002,45,45
5,7,90,False,100.0,0.2307635572078162,125.45,45,45
5,7,95,True,60.0,0.10038965950275029,174.75,48,47
5,7,95,False,81.0,0.24285260195705757,80.75,47,48
5,7,100,True,45.0,0.019465425275309832,274.55,8,92
5,7,100,False,46.0,0.12141469200687148,,50,50
5,8,5,True,61.0,0.0,5.800000000000001,5,0
5,8,5,False,50.0,0.0,5.800000000000001,5,0
5,8,10,True,41.0,0.0,5.800000000000001,10,0
5,8,10,False,54.0,0.0,5.800000000000001,10,0
5,8,15,True,57.0,0.0,5.800000000000001,15,0
5,8,15,False,54.0,0.0,5.800000000000001,15,0
5,8,20,True,56.0,0.0,5.800000000000001,20,0
5,8,20,False,96.0,0.05750785693055141,97.15,20,0
5,8,25,True,58.0,0.0,5.800000000000001,25,0
5,8,25,False,99.0,0.07580092443517705,124.45,12,13
5,8,30,True,53.0,0.0,5.800000000000001,30,0
5,8,30,False,99.0,0.114867341943675,99.10000000000001,15,15
5,8,35,True,62.0,0.0,5.800000000000001,35,0
5,8,35,False,99.0,0.11843884292116053,64.05,17,18
5,8,40,True,55.0,0.0,5.800000000000001,40,0
5,8,40,False,100.0,0.16243086274659635,144.55,20,20
5,8,45,True,56.0,0.0,5.800000000000001,45,0
5,8,45,False,100.0,0.16381297372333625,79.2,22,23
5,8,50,True,56.0,0.0002399331964787233,,21,29
5,8,50,False,55.0,0.08967916927553848,73.25,0,50
5,8,55,True,54.0,0.0006994504527475444,223.5,33,22
5,8,55,False,46.0,0.050094821600461616,76.05,29,26
5,8,60,True,70.0,0.0729270877516679,53.25,30,30
5,8,60,False,100.0,0.1961847805649124,104.85000000000001,30,30
5,8,65,True,74.0,0.07325334039813354,29.85,33,32
5,8,65,False,98.0,0.18742849885885443,79.30000000000001,32,33
5,8,70,True,57.0,0.013917707098367843,104.25,35,35
5,8,70,False,100.0,0.20607962983568737,135.8,35,35
5,8,75,True,88.0,0.16425917258237727,45.95,38,37
5,8,75,False,98.0,0.20445866107659025,74.5,37,38
5,8,80,True,83.0,0.14020245785241092,174.15,41,39
5,8,80,False,98.0,0.2104101438569244,59.85,40,40
5,8,85,True,84.0,0.1479383887499322,,43,42
5,8,85,False,97.0,0.21726972663350813,161.0,45,40
5,8,90,True,78.0,0.1316679558951749,107.55000000000001,46,44
5,8,90,False,99.0,0.22768234213612493,82.30000000000001,45,45
5,8,95,True,72.0,0.09831779846688729,,49,46
5,8,95,False,98.0,0.23551629313696276,62.800000000000004,50,45
5,8,100,True,50.0,0.020668152733045626,35.45,30,70
5,8,100,False,46.0,0.03688629448362573,,50,50
5,9,5,True,52.0,0.0,5.800000000000001,5,0
5,9,5,False,56.0,0.0,5.800000000000001,5,0
5,9,10,True,55.0,0.0,5.800000000000001,10,0
5,9,10,False,54.0,0.0,5.800000000000001,10,0
5,9,15,True,56.0,0.0,5.800000000000001,15,0
5,9,15,False,56.0,0.0,5.800000000000001,15,0
5,9,20,True,52.0,0.0,5.800000000000001,20,0
5,9,20,False,57.0,0.0,5.800000000000001,20,0
5,9,25,True,50.0,0.0,5.800000000000001,25,0
5,9,25,False,99.0,0.07527926273385369,116.35000000000001,12,13
5,9,30,True,56.0,0.0,5.800000000000001,30,0
5,9,30,False,99.0,0.0988537024237541,53.2,15,15
5,9,35,True,52.0,0.0,5.800000000000001,35,0
5,9,35,False,100.0,0.126797887611768,102.85000000000001,17,18
5,9,40,True,49.0,0.0,5.800000000000001,40,0
5,9,40,False,100.0,0.14158038105857282,99.4,20,20
5,9,45,True,50.0,1.1705269647801636e-05,,9,36
5,9,45,False,99.0,0.1412866772129488,,22,23
5,9,50,True,57.0,0.001544983637715885,131.3,25,25
5,9,50,False,100.0,0.16687981056365714,79.95,25,25
5,9,55,True,67.0,0.06209394860494711,56.900000000000006,28,27
5,9,55,False,48.0,0.0063273726302140116,,0,55
5,9,60,True,87.0,0.1411927421966636,41.25,30,30
5,9,60,False,97.0,0.18209054409841643,113.85000000000001,30,30
5,9,65,True,83.0,0.14432878593265167,293.40000000000003,33,32
5,9,65,False,97.0,0.18582132955123976,139.05,32,33
5,9,70,True,48.0,0.04929979741279827,,34,36
5,9,70,False,96.0,0.1981389471954446,142.55,35,35
5,9,75,True,86.0,0.16003147836559087,287.65000000000003,37,38
5,9,75,False,97.0,0.1906404234470744,70.85000000000001,37,38
5,9,80,True,85.0,0.15505919472300014,172.70000000000002,41,39
5,9,80,False,99.0,0.211183047797056,,40,40
5,9,85,True,88.0,0.13883241336315383,179.95000000000002,45,40
5,9,85,False,100.0,0.214693070843177,126.75,43,42
5,9,90,True,81.0,0.15420814484554113,227.8,46,44
5,9,90,False,98.0,0.21956365173653872,138.35,45,45
5,9,95,True,75.0,0.14523104716957413,301.95,49,46
5,9,95,False,99.0,0.222107002695732,105.10000000000001,47,48
5,9,100,True,52.0,0.02390469321322545,87.15,98,2
5,9,100,False,45.0,0.1255804398813314,136.6,50,50
5,10,5,True,49.0,0.0,5.800000000000001,5,0
5,10,5,False,49.0,0.0,5.800000000000001,5,0
5,10,10,True,54.0,0.0,5.800000000000001,10,0
5,10,10,False,49.0,0.0,5.800000000000001,10,0
5,10,15,True,59.0,0.0,5.800000000000001,15,0
5,10,15,False,53.0,0.0,5.800000000000001,15,0
5,10,20,True,58.0,0.0,5.800000000000001,20,0
5,10,20,False,60.0,0.0,5.800000000000001,20,0
5,10,25,True,44.0,0.0,5.800000000000001,25,0
5,10,25,False,99.0,0.07601807989198298,119.45,12,13
5,10,30,True,55.0,0.0,5.800000000000001,30,0
5,10,30,False,100.0,0.10770439981339205,98.60000000000001,15,15
5,10,35,True,58.0,0.0,5.800000000000001,35,0
5,10,35,False,100.0,0.12146700926244434,138.6,17,18
5,10,40,True,48.0,0.0,5.800000000000001,40,0
5,10,40,False,100.0,0.14528992275868227,171.0,20,20
5,10,45,True,58.0,0.0004150351804469995,160.0,20,25
5,10,45,False,99.0,0.1437479144484268,133.65,22,23
5,10,50,True,51.0,0.0007421898692360504,264.55,48,2
5,10,50,False,100.0,0.17594454124426448,141.6,25,25
5,10,55,True,83.0,0.13237525327688596,147.70000000000002,28,27
5,10,55,False,94.0,0.1716131708822307,103.95,27,28
5,10,60,True,80.0,0.1429554063035148,241.8,30,30
5,10,60,False,97.0,0.18096082007157235,97.45,30,30
5,10,65,True,74.0,0.13416954306402074,135.8,33,32
5,10,65,False,97.0,0.18125713104591443,129.20000000000002,32,33
5,10,70,True,85.0,0.16834362622289012,,35,35
5,10,70,False,52.0,0.04439404423636773,19.6,70,0
5,10,75,True,90.0,0.1515636096188695,86.95,38,37
5,10,75,False,96.0,0.18852198873476728,69.65,37,38
5,10,80,True,91.0,0.1703418094861896,49.900000000000006,40,40
5,10,80,False,97.0,0.20373406190120066,108.4,40,40
5,10,85,True,89.0,0.17814497039177127,,43,42
5,10,85,False,98.0,0.19847522683056468,67.55,42,43
5,10,90,True,79.0,0.15927591198102348,131.45000000000002,46,44
5,10,90,False,99.0,0.21786644840503344,171.4,45,45
5,10,95,True,87.0,0.1723858846280938,,48,47
5,10,95,False,98.0,0.22091415539326625,89.7,47,48
5,10,100,True,55.0,0.00362291920572536,,100,0
5,10,100,False,48.0,0.14130767681354675,76.75,51,49
6,0,5,True,48.0,0.0,5.800000000000001,5,0
6,0,5,False,58.0,0.0,5.800000000000001,5,0
6,0,10,True,48.0,0.0,5.800000000000001,10,0
6,0,10,False,52.0,0.0,5.800000000000001,10,0
6,0,15,True,65.0,0.0,5.800000000000001,15,0
6,0,15,False,49.0,0.0,5.800000000000001,15,0
6,0,20,True,54.0,0.0,5.800000000000001,20,0
6,0,20,False,50.0,0.0,5.800000000000001,20,0
6,0,25,True,47.0,0.0,5.800000000000001,25,0
6,0,25,False,97.0,0.07658974065602689,91.0,12,13
6,0,30,True,57.0,0.0,5.800000000000001,30,0
6,0,30,False,98.0,0.11168642304519094,133.9,15,15
6,0,35,True,60.0,0.0,5.800000000000001,35,0
6,0,35,False,98.0,0.12222189539110309,143.15,17,18
6,0,40,True,56.0,0.0,5.800000000000001,40,0
6,0,40,False,97.0,0.1420521985267262,128.6,20,20
6,0,45,True,47.0,0.0,5.800000000000001,45,0
6,0,45,False,98.0,0.1469653028024839,155.8,22,23
6,0,50,True,63.0,0.0,5.800000000000001,50,0
6,0,50,False,98.0,0.17862048769898106,56.550000000000004,25,25
6,0,55,True,52.0,0.1544772552723334,214.10000000000002,28,27
6,0,55,False,47.0,0.19354529751570163,166.4,29,26
6,0,60,True,59.0,0.003801680012167803,,30,30
6,0,60,False,98.0,0.18238890414205422,75.95,30,30
6,0,65,True,55.0,0.0010848598365797554,162.05,33,32
6,0,65,False,98.0,0.2039952458390069,204.85000000000002,32,33
6,0,70,True,51.0,0.0012395560232281535,114.95,35,35
6,0,70,False,99.0,0.2279684092172925,95.7,35,35
6,0,75,True,52.0,0.0015166042597753592,131.95000000000002,26,49
6,0,75,False,98.0,0.20377318905398753,,38,37
6,0,80,True,46.0,0.0017392290556655617,163.55,15,65
6,0,80,False,97.0,0.2273984849412879,124.05000000000001,40,40
6,0,85,True,50.0,0.00014497071557123436,128.8,6,79
6,0,85,False,99.0,0.22469063748858042,133.3,42,43
6,0,90,True,58.0,0.006246307453725879,81.7,45,45
6,0,90,False,100.0,0.22697202431283983,185.8,45,45
6,0,95,True,53.0,0.0027149334539474943,79.15,40,55
6,0,95,False,99.0,0.21275367090233338,127.4,47,48
6,0,100,True,58.0,0.00020382224285455189,130.25,43,57
6,0,100,False,98.0,0.21792542935070855,114.55000000000001,50,50
6,1,5,True,58.0,0.0,5.800000000000001,5,0
6,1,5,False,55.0,0.0,5.800000000000001,5,0
6,1,10,True,55.0,0.0,5.800000000000001,10,0
6,1,10,False,53.0,0.0,5.800000000000001,10,0
6,1,15,True,61.0,0.0,5.800000000000001,15,0
6,1,15,False,44.0,0.0,5.800000000000001,15,0
6,1,20,True,56.0,0.0,5.800000000000001,20,0
6,1,20,False,55.0,0.0,5.800000000000001,20,0
6,1,25,True,50.0,0.0,5.800000000000001,25,0
6,1,25,False,98.0,0.0772080069855283,150.0,13,12
6,1,30,True,40.0,0.0,5.800000000000001,30,0
6,1,30,False,98.0,0.10364896014413591,98.35000000000001,15,15
6,1,35,True,48.0,0.0,5.800000000000001,35,0
6,1,35,False,97.0,0.11831701144181915,103.85000000000001,18,17
6,1,40,True,52.0,0.0,5.800000000000001,40,0
6,1,40,False,97.0,0.1440392354096594,96.95,20,20
6,1,45,True,41.0,0.0,5.800000000000001,45,0
6,1,45,False,52.0,0.15716539464111226,95.35000000000001,22,23
6,1,50,True,53.0,0.0,5.800000000000001,50,0
6,1,50,False,41.0,0.15999059448986175,85.15,28,22
6,1,55,True,44.0,0.0,5.800000000000001,55,0
6,1,55,False,42.0,0.15584201100164152,96.55000000000001,32,23
6,1,60,True,55.0,0.0,5.800000000000001,60,0
6,1,60,False,49.0,0.16774861237708308,99.65,35,25
6,1,65,True,52.0,0.0,5.800000000000001,65,0
6,1,65,False,41.0,0.16539459472239412,97.15,39,26
6,1,70,True,45.0,0.0,5.800000000000001,70,0
6,1,70,False,49.0,0.16977043716959195,162.9,42,28
6,1,75,True,54.0,0.0,5.800000000000001,75,0
6,1,75,False,47.0,0.1747451021524541,102.60000000000001,46,29
6,1,80,True,54.0,0.0,5.800000000000001,80,0
6,1,80,False,46.0,0.17125468591600548,68.15,41,39
6,1,85,True,50.0,0.0,5.800000000000001,85,0
6,1,85,False,41.0,0.1841640123653051,86.65,43,42
6,1,90,True,60.0,0.0,5.800000000000001,90,0
6,1,90,False,50.0,0.19876881044794187,170.8,45,45
6,1,95,True,49.0,0.0,5.800000000000001,95,0
6,1,95,False,57.0,0.19906712326733378,199.25,47,48
6,1,100,True,47.0,0.0,5.800000000000001,100,0
6,1,100,False,100.0,0.21942732065834974,59.550000000000004,50,50
6,2,5,True,52.0,0.0,5.800000000000001,5,0
6,2,5,False,47.0,0.0,5.800000000000001,5,0
6,2,10,True,60.0,0.0,5.800000000000001,10,0
6,2,10,False,45.0,0.0,5.800000000000001,10,0
6,2,15,True,56.0,0.0,5.800000000000001,15,0
6,2,15,False,43.0,0.0,5.800000000000001,15,0
6,2,20,True,48.0,0.0,5.800000000000001,20,0
6,2,20,False,48.0,0.0,5.800000000000001,20,0
6,2,25,True,57.0,0.0,5.800000000000001,25,0
6,2,25,False,98.0,0.0770223616851315,109.85000000000001,12,13
6,2,30,True,57.0,0.0,5.800000000000001,30,0
6,2,30,False,98.0,0.11058376053401693,73.0,15,15
6,2,35,True,58.0,0.0,5.800000000000001,35,0
6,2,35,False,98.0,0.13154043164205012,57.550000000000004,17,18
6,2,40,True,57.0,0.002111133030972888,,40,0
6,2,40,False,100.0,0.15605847623533128,54.75,20,20
6,2,45,True,52.0,0.002168299946973395,221.55,9,36
6,2,45,False,100.0,0.16338545096339477,164.75,23,22
6,2,50,True,50.0,0.0002084339024428657,149.25,35,15
6,2,50,False,100.0,0.1781447828265063,78.55000000000001,25,25
6,2,55,True,61.0,0.0,5.800000000000001,55,0
6,2,55,False,100.0,0.1813363967078861,35.0,28,27
6,2,60,True,58.0,0.0,5.800000000000001,60,0
6,2,60,False,100.0,0.18894490383137905,162.70000000000002,30,30
6,2,65,True,49.0,0.0,5.800000000000001,65,0
6,2,65,False,100.0,0.19001013897657834,197.85000000000002,32,33
6,2,70,True,55.0,0.0,5.800000000000001,70,0
6,2,70,False,99.0,0.1937181510887387,96.4,35,35
6,2,75,True,54.0,0.0,5.800000000000001,75,0
6,2,75,False,100.0,0.19875808087641422,127.45,37,38
6,2,80,True,51.0,0.0,5.800000000000001,80,0
6,2,80,False,100.0,0.20829901567491252,91.9,40,40
6,2,85,True,42.0,0.0,5.800000000000001,85,0
6,2,85,False,100.0,0.20489863919176549,99.15,42,43
6,2,90,True,46.0,0.0,5.800000000000001,90,0
6,2,90,False,99.0,0.2120286265731139,168.4,45,45
6,2,95,True,62.0,0.0,5.800000000000001,95,0
6,2,95,False,100.0,0.21508944968841642,66.4,47,48
6,2,100,True,58.0,0.0,5.800000000000001,100,0
6,2,100,False,99.0,0.21668403214623108,199.5,50,50
6,3,5,True,57.0,0.0,5.800000000000001,5,0
6,3,5,False,52.0,0.0,5.800000000000001,5,0
6,3,10,True,62.0,0.0,5.800000000000001,10,0
6,3,10,False,51.0,0.0,5.800000000000001,10,0
6,3,15,True,56.0,0.0,5.800000000000001,15,0
6,3,15,False,52.0,0.0,5.800000000000001,15,0
6,3,20,True,57.0,0.0,5.800000000000001,20,0
6,3,20,False,56.0,0.0,5.800000000000001,20,0
6,3,25,True,49.0,0.0,5.800000000000001,25,0
6,3,25,False,98.0,0.07502065292678299,48.2,12,13
6,3,30,True,48.0,0.0,5.800000000000001,30,0
6,3,30,False,98.0,0.1048338583804548,76.80000000000001,15,15
6,3,35,True,56.0,0.0013797548343925036,122.7,17,18
6,3,35,False,98.0,0.1293200889366245,87.60000000000001,18,17
6,3,40,True,54.0,0.001459005896595398,163.75,20,20
6,3,40,False,97.0,0.13735845459389992,91.7,20,20
6,3,45,True,57.0,0.0068794809815130135,150.75,22,23
6,3,45,False,98.0,0.14582660294363808,77.7,23,22
6,3,50,True,54.0,0.007508715238203335,128.6,25,25
6,3,50,False,99.0,0.1850497410235276,132.70000000000002,25,25
6,3,55,True,53.0,0.0012632907607415614,103.45,29,26
6,3,55,False,56.0,0.005288626378182664,,0,55
6,3,60,True,54.0,0.01577632724668327,238.85000000000002,30,30
6,3,60,False,47.0,0.07867739572644306,60.150000000000006,57,3
6,3,65,True,54.0,0.013410845689405758,136.3,65,0
6,3,65,False,61.0,0.00463385192225061,61.1,1,64
6,3,70,True,56.0,0.006680684379807873,147.25,35,35
6,3,70,False,54.0,0.00059078515181423,210.95000000000002,0,70
6,3,75,True,52.0,0.06534204198722779,,37,38
6,3,75,False,98.0,0.20653698375441135,71.75,37,38
6,3,80,True,54.0,0.14629518792121826,135.8,40,40
6,3,80,False,84.0,0.19416924864369936,198.8,40,40
6,3,85,True,53.0,0.028132477353728143,97.5,43,42
6,3,85,False,89.0,0.20649762363338453,125.65,43,42
6,3,90,True,49.0,0.0017320520358609548,64.60000000000001,0,90
6,3,90,False,51.0,0.06396912300241886,75.95,0,90
6,3,95,True,49.0,0.05155733089548569,144.3,48,47
6,3,95,False,100.0,0.23003893573306483,132.15,48,47
6,3,100,True,56.0,0.16046760411506336,295.40000000000003,50,50
6,3,100,False,61.0,0.19872155775155437,191.85000000000002,50,50
6,4,5,True,49.0,0.0,5.800000000000001,5,0
6,4,5,False,48.0,0.0,5.800000000000001,5,0
6,4,10,True,52.0,0.0,5.800000000000001,10,0
6,4,10,False,55.0,0.0,5.800000000000001,10,0
6,4,15,True,55.0,0.0,5.800000000000001,15,0
6,4,15,False,66.0,0.0,5.800000000000001,15,0
6,4,20,True,52.0,0.0,5.800000000000001,20,0
6,4,20,False,39.0,0.0,5.800000000000001,20,0
6,4,25,True,54.0,0.0,5.800000000000001,25,0
6,4,25,False,98.0,0.07443345690658786,79.9,13,12
6,4,30,True,46.0,0.0,5.800000000000001,30,0
6,4,30,False,98.0,0.10076451224615238,109.9,15,15
6,4,35,True,51.0,0.0,5.800000000000001,35,0
6,4,35,False,96.0,0.11692472870093558,95.4,18,17
6,4,40,True,59.0,0.0,5.800000000000001,40,0
6,4,40,False,100.0,0.2458392148571337,29.200000000000003,20,20
6,4,45,True,61.0,0.0,5.800000000000001,45,0
6,4,45,False,96.0,0.1467969379928987,160.70000000000002,22,23
6,4,50,True,54.0,0.0,5.800000000000001,50,0
6,4,50,False,97.0,0.16465094636228023,211.05,25,25
6,4,55,True,50.0,5.407448747317568e-06,80.05000000000001,0,55
6,4,55,False,97.0,0.18111702605754917,35.0,27,28
6,4,60,True,53.0,0.00019552430485892273,58.400000000000006,8,52
6,4,60,False,100.0,0.2149270708942226,141.20000000000002,30,30
6,4,65,True,54.0,0.0016203657583744755,177.0,65,0
6,4,65,False,48.0,0.004992523201736015,51.050000000000004,1,64
6,4,70,True,41.0,0.0005097300241704764,32.45,1,69
6,4,70,False,44.0,0.059692576842719614,107.15,35,35
6,4,75,True,42.0,0.01621727233773409,247.05,35,40
6,4,75,False,100.0,0.23610955838253483,,37,38
6,4,80,True,52.0,0.00409531540116262,287.05,68,12
6,4,80,False,100.0,0.21519064382748404,72.3,40,40
6,4,85,True,52.0,0.0225823698000578,98.35000000000001,42,43
6,4,85,False,100.0,0.24023300818794263,102.2,42,43
6,4,90,True,57.0,0.004056547956829339,28.5,6,84
6,4,90,False,57.0,0.03941257722161993,167.70000000000002,90,0
6,4,95,True,48.0,0.0009692986041583867,258.6,2,93
6,4,95,False,48.0,0.002735857472814765,188.10000000000002,0,95
6,4,100,True,48.0,0.17765290120458435,22.950000000000003,50,50
6,4,100,False,50.0,0.22159149426941907,151.20000000000002,50,50
6,5,5,True,54.0,0.0,5.800000000000001,5,0
6,5,5,False,59.0,0.0,5.800000000000001,5,0
6,5,10,True,54.0,0.0,5.800000000000001,10,0
6,5,10,False,57.0,0.0,5.800000000000001,10,0
6,5,15,True,57.0,0.0,5.800000000000001,15,0
6,5,15,False,57.0,0.0,5.800000000000001,15,0
6,5,20,True,52.0,0.0,5.800000000000001,20,0
6,5,20,False,55.0,0.0,5.800000000000001,20,0
6,5,25,True,59.0,0.0,5.800000000000001,25,0
6,5,25,False,98.0,0.07233378664365568,95.2,13,12
6,5,30,True,53.0,0.0,5.800000000000001,30,0
6,5,30,False,97.0,0.10399449924557257,102.45,15,15
6,5,35,True,57.0,0.0,5.800000000000001,35,0
6,5,35,False,98.0,0.12831827066868215,144.45000000000002,17,18
6,5,40,True,56.0,0.0,5.800000000000001,40,0
6,5,40,False,98.0,0.14519488646226245,176.25,20,20
6,5,45,True,57.0,0.0,5.800000000000001,45,0
6,5,45,False,99.0,0.17768935457124427,93.75,22,23
6,5,50,True,46.0,5.027084320593972e-05,55.800000000000004,24,26
6,5,50,False,100.0,0.20138419067519958,150.55,25,25
6,5,55,True,54.0,0.0017531072405434257,80.80000000000001,27,28
6,5,55,False,49.0,0.02877377337846179,124.85000000000001,54,1
6,5,60,True,56.0,0.009840365530806151,59.5,28,32
6,5,60,False,100.0,0.19966591892145436,107.85000000000001,30,30
6,5,65,True,52.0,0.016824633341243563,47.75,33,32
6,5,65,False,54.0,0.08516249039755314,120.15,64,1
6,5,70,True,61.0,0.01847367174913612,33.15,35,35
6,5,70,False,100.0,0.2475025243912413,173.5,35,35
6,5,75,True,49.0,0.0005865509796861254,,0,75
6,5,75,False,97.0,0.2068678009903341,105.05000000000001,37,38
6,5,80,True,56.0,0.07273640891996824,,40,40
6,5,80,False,58.0,0.1285795253644222,60.550000000000004,77,3
6,5,85,True,54.0,0.005240730931075448,44.900000000000006,45,40
6,5,85,False,100.0,0.24460332461039608,215.0,42,43
6,5,90,True,57.0,0.001742365614088224,54.5,30,60
6,5,90,False,100.0,0.24796152036111213,218.0,45,45
6,5,95,True,49.0,0.0012477058693463566,127.75,0,95
6,5,95,False,99.0,0.22178165856104723,102.7,49,46
6,5,100,True,38.0,0.1372341436491136,,50,50
6,5,100,False,44.0,0.22250047525011898,282.5,50,50
6,6,5,True,49.0,0.0,5.800000000000001,5,0
6,6,5,False,48.0,0.0,5.800000000000001,5,0
6,6,10,True,48.0,0.0,5.800000000000001,10,0
6,6,10,False,51.0,0.0,5.800000000000001,10,0
6,6,15,True,45.0,0.0,5.800000000000001,15,0
6,6,15,False,62.0,0.0,5.800000000000001,15,0
6,6,20,True,47.0,0.0,5.800000000000001,20,0
6,6,20,False,59.0,0.0,5.800000000000001,20,0
6,6,25,True,63.0,0.0,5.800000000000001,25,0
6,6,25,False,96.0,0.07401545650683941,88.10000000000001,12,13
6,6,30,True,44.0,0.0,5.800000000000001,30,0
6,6,30,False,97.0,0.10325764144140746,73.85000000000001,15,15
6,6,35,True,57.0,0.0,5.800000000000001,35,0
6,6,35,False,99.0,0.12351463508378238,123.60000000000001,17,18
6,6,40,True,49.0,0.0,5.800000000000001,40,0
6,6,40,False,100.0,0.14899393838746913,143.45000000000002,20,20
6,6,45,True,58.0,7.737781930363971e-06,28.5,26,19
6,6,45,False,100.0,0.16258205941211082,172.4,22,23
6,6,50,True,55.0,0.008580820814508823,31.950000000000003,25,25
6,6,50,False,97.0,0.23316707289356794,127.35000000000001,25,25
6,6,55,True,65.0,0.011039637198557214,176.20000000000002,28,27
6,6,55,False,100.0,0.24445662507075025,84.85000000000001,27,28
6,6,60,True,57.0,0.015284359905837906,53.75,30,30
6,6,60,False,100.0,0.2298618620484834,73.60000000000001,30,30
6,6,65,True,54.0,0.0006665415026520328,256.3,30,35
6,6,65,False,100.0,0.19268947788639842,123.0,32,33
6,6,70,True,42.0,0.000980831274630332,189.15,70,0
6,6,70,False,61.0,0.07801493026378235,44.85,29,41
6,6,75,True,70.0,0.07456547772234473,215.85000000000002,38,37
6,6,75,False,99.0,0.21221954760818051,,37,38
6,6,80,True,50.0,0.008923984845319425,205.4,40,40
6,6,80,False,99.0,0.2112938605360046,153.70000000000002,40,40
6,6,85,True,52.0,0.058869643049692354,,43,42
6,6,85,False,99.0,0.22228670094056885,114.25,42,43
6,6,90,True,59.0,0.06079863900474646,45.300000000000004,45,45
6,6,90,False,100.0,0.22437144242561685,94.35000000000001,46,44
6,6,95,True,54.0,0.08046687294664219,118.15,50,45
6,6,95,False,100.0,0.231035529210106,133.4,48,47
6,6,100,True,60.0,0.05857983586725359,199.60000000000002,87,13
6,6,100,False,52.0,0.18786201105357786,137.45000000000002,50,50
6,7,5,True,53.0,0.0,5.800000000000001,5,0
6,7,5,False,53.0,0.0,5.800000000000001,5,0
6,7,10,True,55.0,0.0,5.800000000000001,10,0
6,7,10,False,50.0,0.0,5.800000000000001,10,0
6,7,15,True,54.0,0.0,5.800000000000001,15,0
6,7,15,False,57.0,0.0,5.800000000000001,15,0
6,7,20,True,53.0,0.0,5.800000000000001,20,0
6,7,20,False,50.0,0.0,5.800000000000001,20,0
6,7,25,True,60.0,0.0,5.800000000000001,25,0
6,7,25,False,98.0,0.07678878234554797,16.7,12,13
6,7,30,True,68.0,0.0,5.800000000000001,30,0
6,7,30,False,100.0,0.11400029388635084,149.70000000000002,15,15
6,7,35,True,48.0,0.0,5.800000000000001,35,0
6,7,35,False,99.0,0.12555688590837616,129.15,17,18
6,7,40,True,59.0,0.00036911639669517406,13.350000000000001,31,9
6,7,40,False,100.0,0.17187886287107576,137.70000000000002,20,20
6,7,45,True,48.0,0.018045945011973926,28.25,41,4
6,7,45,False,92.0,0.17503895416734092,96.65,23,22
6,7,50,True,58.0,0.0,5.800000000000001,50,0
6,7,50,False,100.0,0.22759990398548818,135.25,25,25
6,7,55,True,62.0,0.10088728953408291,,27,28
6,7,55,False,99.0,0.17534949661694849,141.5,27,28
6,7,60,True,47.0,0.009771172223287647,34.6,28,32
6,7,60,False,99.0,0.17582931016157397,56.95,30,30
6,7,65,True,72.0,0.14166120569612542,219.4,33,32
6,7,65,False,52.0,0.011824974998385224,13.350000000000001,1,64
6,7,70,True,69.0,0.10826530997943196,349.95000000000005,35,35
6,7,70,False,47.0,0.0010971450602796412,72.0,0,70
6,7,75,True,82.0,0.13432772172026505,177.60000000000002,38,37
6,7,75,False,97.0,0.20335084394830716,152.70000000000002,37,38
6,7,80,True,71.0,0.17445980030731187,79.75,40,40
6,7,80,False,100.0,0.22293592222556896,238.15,40,40
6,7,85,True,64.0,0.09651688956622946,216.60000000000002,45,40
6,7,85,False,100.0,0.2369284586232137,298.65000000000003,42,43
6,7,90,True,50.0,0.00914032966871768,,90,0
6,7,90,False,100.0,0.24249950983870341,131.3,45,45
6,7,95,True,59.0,0.14941151778542786,,47,48
6,7,95,False,99.0,0.23102128713004572,49.45,49,46
6,7,100,True,44.0,0.03353390715052103,,7,93
6,7,100,False,40.0,0.1318308236621852,103.5,40,60
6,8,5,True,56.0,0.0,5.800000000000001,5,0
6,8,5,False,65.0,0.0,5.800000000000001,5,0
6,8,10,True,58.0,0.0,5.800000000000001,10,0
6,8,10,False,52.0,0.0,5.800000000000001,10,0
6,8,15,True,51.0,0.0,5.800000000000001,15,0
6,8,15,False,53.0,0.0,5.800000000000001,15,0
6,8,20,True,51.0,0.0,5.800000000000001,20,0
6,8,20,False,45.0,0.0,5.800000000000001,20,0
6,8,25,True,55.0,0.0,5.800000000000001,25,0
6,8,25,False,100.0,0.07739619603233192,99.45,13,12
6,8,30,True,47.0,0.0,5.800000000000001,30,0
6,8,30,False,99.0,0.11409819605202143,143.70000000000002,15,15
6,8,35,True,53.0,0.0,5.800000000000001,35,0
6,8,35,False,98.0,0.1116237079646058,31.5,18,17
6,8,40,True,55.0,0.0,5.800000000000001,40,0
6,8,40,False,99.0,0.1379606539712374,37.15,20,20
6,8,45,True,62.0,4.6781590602772415e-05,,18,27
6,8,45,False,99.0,0.1456595876257734,68.3,22,23
6,8,50,True,60.0,0.00015513542418870146,,35,15
6,8,50,False,100.0,0.18959070877861553,75.4,25,25
6,8,55,True,58.0,0.0050223752754489145,,28,27
6,8,55,False,99.0,0.1762784755213325,150.95000000000002,27,28
6,8,60,True,79.0,0.06478409929269636,,30,30
6,8,60,False,99.0,0.2115404396134661,68.60000000000001,30,30
6,8,65,True,85.0,0.1322300986336175,253.10000000000002,33,32
6,8,65,False,98.0,0.1881064837089006,70.4,32,33
6,8,70,True,85.0,0.1546196078559365,199.3,35,35
6,8,70,False,99.0,0.20313885693695805,251.95000000000002,35,35
6,8,75,True,88.0,0.1526933533467947,219.20000000000002,38,37
6,8,75,False,98.0,0.20417414131349462,138.20000000000002,37,38
6,8,80,True,82.0,0.14725756280126517,221.75,41,39
6,8,80,False,99.0,0.21677211467424382,66.60000000000001,40,40
6,8,85,True,53.0,0.003585351039680998,78.85000000000001,3,82
6,8,85,False,98.0,0.2120714840729858,129.4,42,43
6,8,90,True,68.0,0.15332418838472087,216.5,45,45
6,8,90,False,98.0,0.23965237094581143,129.3,46,44
6,8,95,True,65.0,0.1374061148586485,199.15,50,45
6,8,95,False,100.0,0.24334140740187804,162.8,50,45
6,8,100,True,47.0,0.03440628392291964,104.10000000000001,29,71
6,8,100,False,48.0,0.026741601968854726,71.4,30,70
6,9,5,True,52.0,0.0,5.800000000000001,5,0
6,9,5,False,55.0,0.0,5.800000000000001,5,0
6,9,10,True,62.0,0.0,5.800000000000001,10,0
6,9,10,False,60.0,0.0,5.800000000000001,10,0
6,9,15,True,53.0,0.0,5.800000000000001,15,0
6,9,15,False,56.0,0.0,5.800000000000001,15,0
6,9,20,True,49.0,0.0,5.800000000000001,20,0
6,9,20,False,58.0,0.0,5.800000000000001,20,0
6,9,25,True,52.0,0.0,5.800000000000001,25,0
6,9,25,False,100.0,0.07751622598794133,86.10000000000001,12,13
6,9,30,True,53.0,0.0,5.800000000000001,30,0
6,9,30,False,98.0,0.10511040799262966,58.400000000000006,15,15
6,9,35,True,50.0,0.0,5.800000000000001,35,0
6,9,35,False,100.0,0.12247375379865803,151.55,17,18
6,9,40,True,52.0,0.0,5.800000000000001,40,0
6,9,40,False,100.0,0.15888968331921252,97.0,20,20
6,9,45,True,57.0,0.00022242324843244022,,40,5
6,9,45,False,100.0,0.1560806700339876,61.7,22,23
6,9,50,True,42.0,0.001495147083329204,,8,42
6,9,50,False,97.0,0.16113473550103685,186.4,25,25
6,9,55,True,77.0,0.051520967854799656,94.75,28,27
6,9,55,False,96.0,0.16442239305502887,121.7,27,28
6,9,60,True,84.0,0.1390874900304839,255.15,30,30
6,9,60,False,97.0,0.18175235802781914,162.20000000000002,30,30
6,9,65,True,78.0,0.13297838063018777,221.70000000000002,33,32
6,9,65,False,96.0,0.17994653522213921,80.15,32,33
6,9,70,True,83.0,0.14742434909870974,,35,35
6,9,70,False,100.0,0.20925768203061773,128.85,35,35
6,9,75,True,79.0,0.1362007396048781,82.5,39,36
6,9,75,False,98.0,0.19443981419688114,73.10000000000001,37,38
6,9,80,True,45.0,0.019328808009925893,163.70000000000002,75,5
6,9,80,False,99.0,0.20983165263826004,64.10000000000001,40,40
6,9,85,True,80.0,0.15003029951951175,172.5,44,41
6,9,85,False,98.0,0.21597436136048953,109.10000000000001,42,43
6,9,90,True,73.0,0.16348782799224237,,45,45
6,9,90,False,99.0,0.22225670181083815,27.6,45,45
6,9,95,True,77.0,0.14108907880133764,142.1,50,45
6,9,95,False,96.0,0.21896866079754754,200.10000000000002,47,48
6,9,100,True,44.0,0.009208245964069635,,47,53
6,9,100,False,47.0,0.11153486968476514,,53,47
6,10,5,True,58.0,0.0,5.800000000000001,5,0
6,10,5,False,54.0,0.0,5.800000000000001,5,0
6,10,10,True,47.0,0.0,5.800000000000001,10,0
6,10,10,False,58.0,0.0,5.800000000000001,10,0
6,10,15,True,60.0,0.0,5.800000000000001,15,0
6,10,15,False,54.0,0.0,5.800000000000001,15,0
6,10,20,True,52.0,0.0,5.800000000000001,20,0
6,10,20,False,53.0,0.00027129710433243303,97.30000000000001,17,3
6,10,25,True,55.0,0.0,5.800000000000001,25,0
6,10,25,False,99.0,0.07579857228757308,128.75,13,12
6,10,30,True,49.0,0.0,5.800000000000001,30,0
6,10,30,False,100.0,0.10477403879121189,107.80000000000001,15,15
6,10,35,True,56.0,0.0,5.800000000000001,35,0
6,10,35,False,100.0,0.13435811131525136,51.0,17,18
6,10,40,True,57.0,0.0,5.800000000000001,40,0
6,10,40,False,100.0,0.16348992300096485,74.9,20,20
6,10,45,True,55.0,0.0001525491419810659,69.55,16,29
6,10,45,False,100.0,0.15877302441410837,100.15,22,23
6,10,50,True,71.0,0.11331447122584916,,25,25
6,10,50,False,40.0,0.07313549579049362,67.8,49,1
6,10,55,True,76.0,0.12352039877754141,254.15,28,27
6,10,55,False,56.0,0.007661395517260166,,0,55
6,10,60,True,61.0,0.005702342802544294,193.95000000000002,2,58
6,10,60,False,45.0,0.03764568771747198,47.5,30,30
6,10,65,True,86.0,0.14892203365463702,244.35000000000002,33,32
6,10,65,False,97.0,0.1821516663629531,108.25,32,33
6,10,70,True,88.0,0.16031962068288994,168.05,35,35
6,10,70,False,97.0,0.19097045793874512,204.70000000000002,35,35
6,10,75,True,88.0,0.16125710428350673,,38,37
6,10,75,False,97.0,0.19198420847618367,147.55,37,38
6,10,80,True,85.0,0.16210253719705742,207.75,40,40
6,10,80,False,49.0,0.09735381635654543,126.15,60,20
6,10,85,True,82.0,0.1588362390490883,173.9,43,42
6,10,85,False,99.0,0.20612960294890395,86.10000000000001,42,43
6,10,90,True,81.0,0.17175173405283933,109.35000000000001,45,45
6,10,90,False,99.0,0.2187901869970929,104.05000000000001,45,45
6,10,95,True,82.0,0.18591299087261484,160.85000000000002,49,46
6,10,95,False,96.0,0.21198815704534582,67.55,47,48
6,10,100,True,50.0,0.00854811313449573,15.25,94,6
6,10,100,False,36.0,0.05129961154401324,167.15,39,61
7,0,5,True,50.0,0.0,5.800000000000001,5,0
7,0,5,False,57.0,0.0,5.800000000000001,5,0
7,0,10,True,58.0,0.0,5.800000000000001,10,0
7,0,10,False,61.0,0.0,5.800000000000001,10,0
7,0,15,True,57.0,0.0,5.800000000000001,15,0
7,0,15,False,54.0,0.0,5.800000000000001,15,0
7,0,20,True,57.0,0.0,5.800000000000001,20,0
7,0,20,False,57.0,0.0,5.800000000000001,20,0
7,0,25,True,53.0,0.0,5.800000000000001,25,0
7,0,25,False,97.0,0.078115590327564,57.7,12,13
7,0,30,True,58.0,0.0,5.800000000000001,30,0
7,0,30,False,98.0,0.11048645706789234,78.55000000000001,15,15
7,0,35,True,56.0,0.0,5.800000000000001,35,0
7,0,35,False,98.0,0.12113957786315675,97.4,18,17
7,0,40,True,56.0,0.0,5.800000000000001,40,0
7,0,40,False,98.0,0.1456008937677742,60.0,20,20
7,0,45,True,50.0,0.0,5.800000000000001,45,0
7,0,45,False,98.0,0.15176415852604042,194.25,23,22
7,0,50,True,65.0,0.0,5.800000000000001,50,0
7,0,50,False,97.0,0.1704246399862538,98.45,25,25
7,0,55,True,53.0,0.1241192007816956,90.75,28,27
7,0,55,False,100.0,0.26168174668390354,91.80000000000001,27,28
7,0,60,True,51.0,0.014545246534956676,60.35,34,26
7,0,60,False,98.0,0.16538208627139625,97.45,29,31
7,0,65,True,47.0,0.0005328541944468834,157.8,33,32
7,0,65,False,55.0,0.20086854635529922,143.9,35,30
7,0,70,True,58.0,0.0009088689217376793,240.3,0,70
7,0,70,False,52.0,0.2381767370007518,91.35000000000001,35,35
7,0,75,True,48.0,0.000969740823328168,123.10000000000001,30,45
7,0,75,False,98.0,0.2265958856817028,77.85000000000001,37,38
7,0,80,True,52.0,0.00014353121605884084,116.85000000000001,2,78
7,0,80,False,95.0,0.2314523931510592,110.65,40,40
7,0,85,True,51.0,0.03422053923188758,141.8,43,42
7,0,85,False,98.0,0.20409740905032503,205.15,42,43
7,0,90,True,48.0,0.0004908963534310806,124.95,90,0
7,0,90,False,100.0,0.25383592899620067,,45,45
7,0,95,True,49.0,0.0003015045973974884,92.75,79,16
7,0,95,False,99.0,0.2102882467008912,103.9,47,48
7,0,100,True,53.0,0.0002847115942865016,131.5,98,2
7,0,100,False,99.0,0.24244200192509605,,50,50
7,1,5,True,51.0,0.0,5.800000000000001,5,0
7,1,5,False,52.0,0.0,5.800000000000001,5,0
7,1,10,True,51.0,0.0,5.800000000000001,10,0
7,1,10,False,51.0,0.0,5.800000000000001,10,0
7,1,15,True,54.0,0.0,5.800000000000001,15,0
7,1,15,False,51.0,0.0,5.800000000000001,15,0
7,1,20,True,46.0,0.0,5.800000000000001,20,0
7,1,20,False,52.0,0.0,5.800000000000001,20,0
7,1,25,True,48.0,0.0,5.800000000000001,25,0
7,1,25,False,98.0,0.07656994053120386,162.3,12,13
7,1,30,True,48.0,0.0,5.800000000000001,30,0
7,1,30,False,98.0,0.1060973902362768,37.5,15,15
7,1,35,True,60.0,0.0,5.800000000000001,35,0
7,1,35,False,98.0,0.11950419139105059,102.10000000000001,17,18
7,1,40,True,54.0,0.0,5.800000000000001,40,0
7,1,40,False,98.0,0.14571511294369913,73.5,20,20
7,1,45,True,51.0,0.0,5.800000000000001,45,0
7,1,45,False,43.0,0.15599114098769185,67.9,23,22
7,1,50,True,56.0,0.0,5.800000000000001,50,0
7,1,50,False,51.0,0.1575610734445562,103.75,29,21
7,1,55,True,55.0,0.0,5.800000000000001,55,0
7,1,55,False,49.0,0.15767300890922137,74.9,34,21
7,1,60,True,56.0,0.0,5.800000000000001,60,0
7,1,60,False,49.0,0.1712056024202736,128.85,35,25
7,1,65,True,49.0,0.0,5.800000000000001,65,0
7,1,65,False,47.0,0.15860553006476114,97.4,39,26
7,1,70,True,44.0,0.0,5.800000000000001,70,0
7,1,70,False,48.0,0.16837158788168996,120.80000000000001,42,28
7,1,75,True,51.0,0.0,5.800000000000001,75,0
7,1,75,False,54.0,0.1631010514465031,,44,31
7,1,80,True,59.0,0.0,5.800000000000001,80,0
7,1,80,False,44.0,0.17842375425746929,98.05000000000001,44,36
7,1,85,True,64.0,0.0,5.800000000000001,85,0
7,1,85,False,43.0,0.18319457494783864,120.2,43,42
7,1,90,True,56.0,0.0,5.800000000000001,90,0
7,1,90,False,47.0,0.20005668238332067,77.25,45,45
7,1,95,True,53.0,0.0,5.800000000000001,95,0
7,1,95,False,44.0,0.20425467690697405,71.7,48,47
7,1,100,True,62.0,0.0,5.800000000000001,100,0
7,1,100,False,100.0,0.2274974833352785,95.95,50,50
7,2,5,True,53.0,0.0,5.800000000000001,5,0
7,2,5,False,45.0,0.0,5.800000000000001,5,0
7,2,10,True,54.0,0.0,5.800000000000001,10,0
7,2,10,False,44.0,0.0,5.800000000000001,10,0
7,2,15,True,52.0,0.0,5.800000000000001,15,0
7,2,15,False,63.0,0.0,5.800000000000001,15,0
7,2,20,True,59.0,0.0,5.800000000000001,20,0
7,2,20,False,52.0,0.0,5.800000000000001,20,0
7,2,25,True,50.0,0.0,5.800000000000001,25,0
7,2,25,False,98.0,0.07649671747741277,66.45,12,13
7,2,30,True,51.0,0.0,5.800000000000001,30,0
7,2,30,False,98.0,0.11089846502571803,97.85000000000001,15,15
7,2,35,True,49.0,0.0,5.800000000000001,35,0
7,2,35,False,98.0,0.12828264988940546,153.05,18,17
7,2,40,True,56.0,0.008098799368319115,132.75,20,20
7,2,40,False,99.0,0.16326912775149147,74.15,20,20
7,2,45,True,51.0,0.002940936960441074,103.95,23,22
7,2,45,False,99.0,0.16567683343944573,109.7,22,23
7,2,50,True,59.0,0.0035188996998379973,101.65,25,25
7,2,50,False,100.0,0.18351544767528283,171.65,25,25
7,2,55,True,56.0,0.0,5.800000000000001,55,0
7,2,55,False,99.0,0.18453659140613826,104.2,27,28
7,2,60,True,52.0,0.0,5.800000000000001,60,0
7,2,60,False,100.0,0.18863848514380194,73.8,30,30
7,2,65,True,45.0,0.0,5.800000000000001,65,0
7,2,65,False,100.0,0.18929199767838997,166.65,33,32
7,2,70,True,44.0,0.0,5.800000000000001,70,0
7,2,70,False,100.0,0.19899988432409846,99.05000000000001,35,35
7,2,75,True,53.0,0.0,5.800000000000001,75,0
7,2,75,False,100.0,0.19943257422382607,129.70000000000002,38,37
7,2,80,True,54.0,0.0,5.800000000000001,80,0
7,2,80,False,100.0,0.2060420792146275,144.25,40,40
7,2,85,True,58.0,0.0,5.800000000000001,85,0
7,2,85,False,100.0,0.2048760018162613,128.45000000000002,43,42
7,2,90,True,51.0,0.0,5.800000000000001,90,0
7,2,90,False,99.0,0.213985220571163,137.4,45,45
7,2,95,True,54.0,0.0,5.800000000000001,95,0
7,2,95,False,100.0,0.21239936077301455,131.0,47,48
7,2,100,True,55.0,0.0,5.800000000000001,100,0
7,2,100,False,100.0,0.2172346688794544,69.25,50,50
7,3,5,True,52.0,0.0,5.800000000000001,5,0
7,3,5,False,55.0,0.0,5.800000000000001,5,0
7,3,10,True,53.0,0.0,5.800000000000001,10,0
7,3,10,False,54.0,0.0,5.800000000000001,10,0
7,3,15,True,62.0,0.0,5.800000000000001,15,0
7,3,15,False,50.0,0.0,5.800000000000001,15,0
7,3,20,True,57.0,0.0,5.800000000000001,20,0
7,3,20,False,51.0,0.0,5.800000000000001,20,0
7,3,25,True,50.0,0.0,5.800000000000001,25,0
7,3,25,False,98.0,0.07321186232622598,141.35,14,11
7,3,30,True,60.0,0.0,5.800000000000001,30,0
7,3,30,False,98.0,0.10887054576610358,92.65,15,15
7,3,35,True,61.0,0.0026918937740166063,161.35000000000002,17,18
7,3,35,False,98.0,0.12310992770049758,47.900000000000006,18,17
7,3,40,True,51.0,0.0002820807633475752,133.45000000000002,8,32
7,3,40,False,97.0,0.14035567229494975,68.65,20,20
7,3,45,True,61.0,0.0012241723830767536,163.35000000000002,22,23
7,3,45,False,98.0,0.14526807796386743,221.35000000000002,22,23
7,3,50,True,48.0,0.006490048112173875,139.65,25,25
7,3,50,False,56.0,0.020335119675261793,126.25,50,0
7,3,55,True,45.0,0.024963951727011116,192.9,28,27
7,3,55,False,51.0,0.0331194208284075,42.650000000000006,54,1
7,3,60,True,53.0,0.004935725962610452,116.4,30,30
7,3,60,False,53.0,0.04585430549561615,,60,0
7,3,65,True,57.0,0.018034870354834004,166.55,33,32
7,3,65,False,47.0,0.005945979991754251,213.35000000000002,1,64
7,3,70,True,58.0,0.18704238449617086,254.85000000000002,35,35
7,3,70,False,51.0,0.05205371672676265,184.5,70,0
7,3,75,True,55.0,0.002323341893929592,238.4,75,0
7,3,75,False,50.0,0.0536787958393665,89.80000000000001,38,37
7,3,80,True,56.0,0.016678768221638003,192.60000000000002,0,80
7,3,80,False,67.0,0.1795396120819297,227.8,40,40
7,3,85,True,55.0,0.032031655204784334,,18,67
7,3,85,False,84.0,0.2027779686589402,258.5,43,42
7,3,90,True,56.0,0.008169228636139714,,45,45
7,3,90,False,83.0,0.1926696077483097,123.05000000000001,45,45
7,3,95,True,52.0,0.11415282481669549,156.85000000000002,48,47
7,3,95,False,100.0,0.218624401986542,326.75,48,47
7,3,100,True,63.0,0.1700595228793604,,50,50
7,3,100,False,52.0,0.1755440456840523,55.7,50,50
7,4,5,True,55.0,0.0,5.800000000000001,5,0
7,4,5,False,62.0,0.0,5.800000000000001,5,0
7,4,10,True,47.0,0.0,5.800000000000001,10,0
7,4,10,False,50.0,0.0,5.800000000000001,10,0
7,4,15,True,47.0,0.0,5.800000000000001,15,0
7,4,15,False,57.0,0.0,5.800000000000001,15,0
7,4,20,True,59.0,0.0,5.800000000000001,20,0
7,4,20,False,63.0,0.0,5.800000000000001,20,0
7,4,25,True,51.0,0.0,5.800000000000001,25,0
7,4,25,False,98.0,0.0748616943206273,85.60000000000001,12,13
7,4,30,True,51.0,0.0,5.800000000000001,30,0
7,4,30,False,97.0,0.11228384120332117,75.5,15,15
7,4,35,True,58.0,0.0,5.800000000000001,35,0
7,4,35,False,97.0,0.11687905612077466,96.75,17,18
7,4,40,True,45.0,0.0,5.800000000000001,40,0
7,4,40,False,98.0,0.14036115788200101,213.75,20,20
7,4,45,True,57.0,0.0,5.800000000000001,45,0
7,4,45,False,96.0,0.15870096348008011,120.0,22,23
7,4,50,True,51.0,0.0,5.800000000000001,50,0
7,4,50,False,99.0,0.17428231593413676,100.10000000000001,25,25
7,4,55,True,51.0,1.7892284595057214e-05,79.60000000000001,1,54
7,4,55,False,100.0,0.2091394532676875,33.4,27,28
7,4,60,True,55.0,0.0008338852703382238,,60,0
7,4,60,False,59.0,0.03729815238529903,,60,0
7,4,65,True,51.0,0.00012413674099311095,,0,65
7,4,65,False,100.0,0.20486698251370836,85.5,32,33
7,4,70,True,54.0,0.0006630961293667743,,30,40
7,4,70,False,46.0,0.0912160818792836,222.20000000000002,35,35
7,4,75,True,52.0,0.0011264201903787314,53.0,7,68
7,4,75,False,99.0,0.21954936922472207,137.85,37,38
7,4,80,True,55.0,0.007405438106872078,,39,41
7,4,80,False,100.0,0.21352382872504877,105.7,40,40
7,4,85,True,59.0,0.01575784015549974,,43,42
7,4,85,False,45.0,0.06867617259645402,88.4,85,0
7,4,90,True,50.0,0.004854335477027863,217.20000000000002,45,45
7,4,90,False,99.0,0.21155875394200863,125.05000000000001,45,45
7,4,95,True,62.0,0.012883092837411151,273.5,48,47
7,4,95,False,96.0,0.24198844418565107,102.5,47,48
7,4,100,True,49.0,0.150654057941859,146.55,51,49
7,4,100,False,55.0,0.2177413569455992,,50,50
7,5,5,True,57.0,0.0,5.800000000000001,5,0
7,5,5,False,44.0,0.0,5.800000000000001,5,0
7,5,10,True,58.0,0.0,5.800000000000001,10,0
7,5,10,False,60.0,0.0,5.800000000000001,10,0
7,5,15,True,46.0,0.0,5.800000000000001,15,0
7,5,15,False,56.0,0.0,5.800000000000001,15,0
7,5,20,True,56.0,0.0,5.800000000000001,20,0
7,5,20,False,56.0,0.0,5.800000000000001,20,0
7,5,25,True,58.0,0.0,5.800000000000001,25,0
7,5,25,False,97.0,0.07455055232588491,98.30000000000001,13,12
7,5,30,True,58.0,0.0,5.800000000000001,30,0
7,5,30,False,96.0,0.10737563913122201,147.75,15,15
7,5,35,True,49.0,0.0,5.800000000000001,35,0
7,5,35,False,96.0,0.12621459991250772,104.60000000000001,17,18
7,5,40,True,51.0,0.0,5.800000000000001,40,0
7,5,40,False,99.0,0.15336947301733425,210.05,20,20
7,5,45,True,59.0,0.0,5.800000000000001,45,0
7,5,45,False,99.0,0.15790230339741435,70.9,22,23
7,5,50,True,54.0,1.426727083473367e-05,13.100000000000001,1,49
7,5,50,False,42.0,0.04430666013297316,55.75,40,10
7,5,55,True,51.0,2.7658418882802348e-05,,0,55
7,5,55,False,53.0,0.006316139839937659,154.70000000000002,1,54
7,5,60,True,52.0,0.0017723598021502323,34.0,10,50
7,5,60,False,100.0,0.2165355216349809,122.0,30,30
7,5,65,True,52.0,0.009338907889835,51.800000000000004,32,33
7,5,65,False,65.0,0.10211995446418926,100.85000000000001,0,65
7,5,70,True,51.0,0.03257068784187304,327.1,36,34
7,5,70,False,70.0,0.1719941348495933,63.300000000000004,39,31
7,5,75,True,46.0,0.014975199988032567,91.4,37,38
7,5,75,False,47.0,0.06919757673504713,49.85,74,1
7,5,80,True,56.0,0.009693797092886662,17.25,55,25
7,5,80,False,100.0,0.2118697411889874,166.0,40,40
7,5,85,True,57.0,0.02517518669700266,132.4,43,42
7,5,85,False,48.0,0.032393404561880515,59.900000000000006,1,84
7,5,90,True,60.0,0.00404619693127264,56.400000000000006,19,71
7,5,90,False,97.0,0.2394813812706443,102.25,47,43
7,5,95,True,57.0,0.005574944194976447,114.55000000000001,44,51
7,5,95,False,74.0,0.2084703419744179,119.85000000000001,48,47
7,5,100,True,54.0,0.0842859027217452,99.60000000000001,63,37
7,5,100,False,48.0,0.21149875061183745,293.5,50,50
7,6,5,True,49.0,0.0,5.800000000000001,5,0
7,6,5,False,57.0,0.0,5.800000000000001,5,0
7,6,10,True,45.0,0.0,5.800000000000001,10,0
7,6,10,False,65.0,0.0,5.800000000000001,10,0
7,6,15,True,62.0,0.0,5.800000000000001,15,0
7,6,15,False,56.0,0.0,5.800000000000001,15,0
7,6,20,True,52.0,0.0,5.800000000000001,20,0
7,6,20,False,62.0,0.0,5.800000000000001,20,0
7,6,25,True,52.0,0.0,5.800000000000001,25,0
7,6,25,False,94.0,0.08054487751355519,89.35000000000001,12,13
7,6,30,True,51.0,0.0,5.800000000000001,30,0
7,6,30,False,98.0,0.10712229761157235,60.150000000000006,15,15
7,6,35,True,50.0,0.0,5.800000000000001,35,0
7,6,35,False,99.0,0.12193349681352492,66.85000000000001,18,17
7,6,40,True,58.0,0.0,5.800000000000001,40,0
7,6,40,False,100.0,0.16983079961243894,266.65000000000003,20,20
7,6,45,True,57.0,0.00011104711449887651,47.400000000000006,32,13
7,6,45,False,100.0,0.1658145900931729,93.80000000000001,22,23
7,6,50,True,59.0,0.022514630396722846,82.80000000000001,25,25
7,6,50,False,100.0,0.18196248539683033,133.55,25,25
7,6,55,True,56.0,0.022005028049027084,155.3,28,27
7,6,55,False,64.0,0.006641397832903324,200.95000000000002,1,54
7,6,60,True,61.0,0.041234734582853275,,30,30
7,6,60,False,68.0,0.19040838143728017,65.2,0,60
7,6,65,True,60.0,0.07237437333349364,,32,33
7,6,65,False,99.0,0.19062213162758088,132.6,33,32
7,6,70,True,67.0,0.08614308468675844,,35,35
7,6,70,False,100.0,0.20397220257188933,132.3,35,35
7,6,75,True,70.0,0.07487386272752652,74.3,37,38
7,6,75,False,98.0,0.20356563883562415,68.9,37,38
7,6,80,True,54.0,0.10515906368655337,,40,40
7,6,80,False,48.0,0.05465676600005343,89.2,80,0
7,6,85,True,55.0,0.035929583453854656,286.05,43,42
7,6,85,False,100.0,0.23606069993866766,173.5,42,43
7,6,90,True,54.0,0.01773213229042209,125.85000000000001,31,59
7,6,90,False,99.0,0.21777534613567104,135.4,45,45
7,6,95,True,54.0,0.027934058622849676,234.10000000000002,48,47
7,6,95,False,98.0,0.22227403888025152,125.9,49,46
7,6,100,True,54.0,0.10058551109566381,138.35,61,39
7,6,100,False,45.0,0.1609546763728514,171.75,50,50
7,7,5,True,52.0,0.0,5.800000000000001,5,0
7,7,5,False,61.0,0.0,5.800000000000001,5,0
7,7,10,True,45.0,0.0,5.800000000000001,10,0
7,7,10,False,55.0,0.0,5.800000000000001,10,0
7,7,15,True,47.0,0.0,5.800000000000001,15,0
7,7,15,False,52.0,0.0,5.800000000000001,15,0
7,7,20,True,48.0,0.0,5.800000000000001,20,0
7,7,20,False,53.0,0.0,5.800000000000001,20,0
7,7,25,True,48.0,0.0,5.800000000000001,25,0
7,7,25,False,97.0,0.08157139344239325,166.4,12,13
7,7,30,True,51.0,0.0,5.800000000000001,30,0
7,7,30,False,98.0,0.1061578141871432,94.05000000000001,15,15
7,7,35,True,64.0,0.0,5.800000000000001,35,0
7,7,35,False,100.0,0.13440999643100998,52.0,17,18
7,7,40,True,51.0,0.00012064631399850195,57.25,26,14
7,7,40,False,97.0,0.14868659278636878,126.05000000000001,20,20
7,7,45,True,47.0,0.003244213362703906,1.6500000000000001,23,22
7,7,45,False,99.0,0.14109860390596402,58.650000000000006,22,23
7,7,50,True,51.0,0.0020246250935841985,119.30000000000001,2,48
7,7,50,False,42.0,0.04569237492264925,62.800000000000004,25,25
7,7,55,True,55.0,0.004009684147455997,19.900000000000002,15,40
7,7,55,False,52.0,0.020037030686622114,82.2,0,55
7,7,60,True,69.0,0.05343581136594678,11.4,30,30
7,7,60,False,65.0,0.0035851624388054414,,0,60
7,7,65,True,66.0,0.032503393834699724,24.450000000000003,33,32
7,7,65,False,99.0,0.1765187426343387,79.4,32,33
7,7,70,True,75.0,0.10456926188769602,17.85,35,35
7,7,70,False,100.0,0.21138865277278784,121.10000000000001,35,35
7,7,75,True,83.0,0.16603970810867408,,38,37
7,7,75,False,57.0,0.007510612929958704,196.85000000000002,1,74
7,7,80,True,55.0,0.15069091923635022,,40,40
7,7,80,False,100.0,0.22646273145377532,156.3,40,40
7,7,85,True,51.0,0.002281968866874824,110.05000000000001,1,84
7,7,85,False,99.0,0.21791774199248348,37.6,42,43
7,7,90,True,67.0,0.09463334282789526,182.8,50,40
7,7,90,False,99.0,0.22802718898763363,159.15,45,45
7,7,95,True,61.0,0.08219852068963483,,47,48
7,7,95,False,99.0,0.2263835141596394,125.85000000000001,48,47
7,7,100,True,53.0,0.017200492393756917,,74,26
7,7,100,False,46.0,0.10562769002533577,,50,50
7,8,5,True,50.0,0.0,5.800000000000001,5,0
7,8,5,False,57.0,0.0,5.800000000000001,5,0
7,8,10,True,58.0,0.0,5.800000000000001,10,0
7,8,10,False,59.0,0.0,5.800000000000001,10,0
7,8,15,True,54.0,0.0,5.800000000000001,15,0
7,8,15,False,54.0,0.0,5.800000000000001,15,0
7,8,20,True,50.0,0.0,5.800000000000001,20,0
7,8,20,False,59.0,0.0,5.800000000000001,20,0
7,8,25,True,48.0,0.0,5.800000000000001,25,0
7,8,25,False,99.0,0.07743972297798363,89.60000000000001,12,13
7,8,30,True,62.0,0.0,5.800000000000001,30,0
7,8,30,False,97.0,0.11340861380807256,72.8,15,15
7,8,35,True,56.0,0.0,5.800000000000001,35,0
7,8,35,False,99.0,0.12116891589504754,170.35000000000002,17,18
7,8,40,True,46.0,9.471569966420913e-05,,15,25
7,8,40,False,98.0,0.1357161118293621,103.9,20,20
7,8,45,True,46.0,3.0425488057236153e-05,,24,21
7,8,45,False,100.0,0.16195087974264635,129.65,22,23
7,8,50,True,48.0,0.0002949393669485997,,4,46
7,8,50,False,47.0,0.01815051564832551,278.95,50,0
7,8,55,True,45.0,0.0008392342011179858,,24,31
7,8,55,False,100.0,0.16107144981499438,81.7,28,27
7,8,60,True,72.0,0.034458297238685605,55.6,30,30
7,8,60,False,100.0,0.2178892217298352,106.2,30,30
7,8,65,True,81.0,0.13171359495586307,105.65,33,32
7,8,65,False,97.0,0.18299169436667906,75.75,32,33
7,8,70,True,59.0,0.09265847174195313,161.20000000000002,35,35
7,8,70,False,100.0,0.20454038194685892,115.60000000000001,35,35
7,8,75,True,88.0,0.15861550858919327,4.800000000000001,38,37
7,8,75,False,99.0,0.20069305618496908,224.10000000000002,37,38
7,8,80,True,83.0,0.1546176747272897,230.0,41,39
7,8,80,False,98.0,0.21295799686546385,196.65,40,40
7,8,85,True,74.0,0.12615562668748495,,43,42
7,8,85,False,99.0,0.21086992052404502,89.65,42,43
7,8,90,True,70.0,0.1472763248495067,,45,45
7,8,90,False,97.0,0.2318807191223417,91.9,46,44
7,8,95,True,60.0,0.08781651446270669,236.60000000000002,50,45
7,8,95,False,55.0,0.15481075138946918,31.8,74,21
7,8,100,True,45.0,0.021285801011863184,,8,92
7,8,100,False,51.0,0.11988574659810343,,50,50
7,9,5,True,45.0,0.0,5.800000000000001,5,0
7,9,5,False,63.0,0.0,5.800000000000001,5,0
7,9,10,True,49.0,0.0,5.800000000000001,10,0
7,9,10,False,48.0,0.0,5.800000000000001,10,0
7,9,15,True,58.0,0.0,5.800000000000001,15,0
7,9,15,False,55.0,0.0,5.800000000000001,15,0
7,9,20,True,45.0,0.0,5.800000000000001,20,0
7,9,20,False,56.0,0.000283663297013335,97.30000000000001,5,15
7,9,25,True,52.0,0.0,5.800000000000001,25,0
7,9,25,False,99.0,0.07772520268646918,93.2,12,13
7,9,30,True,61.0,0.0,5.800000000000001,30,0
7,9,30,False,99.0,0.10686731808424557,52.0,15,15
7,9,35,True,50.0,0.0,5.800000000000001,35,0
7,9,35,False,99.0,0.11653116153972018,90.2,17,18
7,9,40,True,44.0,0.0,5.800000000000001,40,0
7,9,40,False,100.0,0.1809500625056529,97.75,20,20
7,9,45,True,59.0,1.231381710271311e-05,227.15,44,1
7,9,45,False,100.0,0.17752796452527386,150.6,22,23
7,9,50,True,52.0,0.0011583481883836084,53.050000000000004,29,21
7,9,50,False,51.0,0.002525812338820999,131.25,0,50
7,9,55,True,73.0,0.042504993267041734,67.10000000000001,28,27
7,9,55,False,97.0,0.16535116253518806,143.20000000000002,27,28
7,9,60,True,75.0,0.12958285695105967,214.9,30,30
7,9,60,False,100.0,0.18518599745855946,174.20000000000002,30,30
7,9,65,True,78.0,0.13702613666069402,53.050000000000004,33,32
7,9,65,False,52.0,0.018218204940068365,86.10000000000001,32,33
7,9,70,True,84.0,0.14478720961635877,,35,35
7,9,70,False,99.0,0.1974315061688875,110.15,35,35
7,9,75,True,85.0,0.14717414125845676,192.65,39,36
7,9,75,False,99.0,0.19867598914813067,74.35000000000001,37,38
7,9,80,True,83.0,0.1554039233527452,222.20000000000002,41,39
7,9,80,False,99.0,0.21627208970741982,,40,40
7,9,85,True,92.0,0.1548065650840236,193.20000000000002,44,41
7,9,85,False,97.0,0.20938839140322785,59.45,43,42
7,9,90,True,78.0,0.14863006557454425,237.60000000000002,47,43
7,9,90,False,100.0,0.22129511708996671,,45,45
7,9,95,True,81.0,0.16162844678617158,146.4,48,47
7,9,95,False,100.0,0.22346140768783737,97.60000000000001,49,46
7,9,100,True,44.0,0.008739807077032476,,100,0
7,9,100,False,50.0,0.11015389512520586,106.10000000000001,58,42
7,10,5,True,60.0,0.0,5.800000000000001,5,0
7,10,5,False,60.0,0.0,5.800000000000001,5,0
7,10,10,True,53.0,0.0,5.800000000000001,10,0
7,10,10,False,57.0,0.0,5.800000000000001,10,0
7,10,15,True,57.0,0.0,5.800000000000001,15,0
7,10,15,False,49.0,0.0,5.800000000000001,15,0
7,10,20,True,57.0,0.0,5.800000000000001,20,0
7,10,20,False,50.0,0.0,5.800000000000001,20,0
7,10,25,True,46.0,0.0,5.800000000000001,25,0
7,10,25,False,97.0,0.07559279989600297,106.4,13,12
7,10,30,True,58.0,0.0,5.800000000000001,30,0
7,10,30,False,99.0,0.10725412561031257,127.25,15,15
7,10,35,True,56.0,0.0,5.800000000000001,35,0
7,10,35,False,100.0,0.12026589209481812,100.30000000000001,17,18
7,10,40,True,49.0,0.0,5.800000000000001,40,0
7,10,40,False,100.0,0.15804036508570973,297.95,20,20
7,10,45,True,59.0,0.00029423596245802496,,17,28
7,10,45,False,100.0,0.1454412688751242,57.95,23,22
7,10,50,True,68.0,0.08132907717004323,90.30000000000001,25,25
7,10,50,False,99.0,0.1670124043925735,138.75,25,25
7,10,55,True,71.0,0.10140104292813211,,28,27
7,10,55,False,97.0,0.169327613217086,79.55000000000001,27,28
7,10,60,True,75.0,0.13830431495976836,220.75,30,30
7,10,60,False,98.0,0.1824143992797155,134.35,30,30
7,10,65,True,51.0,0.0010709680216971094,,21,44
7,10,65,False,98.0,0.17213305349478042,135.8,32,33
7,10,70,True,98.0,0.15478782519621984,269.55,35,35
7,10,70,False,100.0,0.20180540510976905,266.95,35,35
7,10,75,True,89.0,0.15781568321659178,,38,37
7,10,75,False,60.0,0.004223163781334068,144.20000000000002,0,75
7,10,80,True,89.0,0.15657557520838716,161.75,40,40
7,10,80,False,98.0,0.20835585712556878,65.8,40,40
7,10,85,True,88.0,0.1580632697928812,151.15,43,42
7,10,85,False,100.0,0.21198434987169634,187.9,42,43
7,10,90,True,86.0,0.16534116126208895,178.45000000000002,46,44
7,10,90,False,98.0,0.2131198411851772,58.300000000000004,45,45
7,10,95,True,91.0,0.18537020445718308,207.75,48,47
7,10,95,False,100.0,0.23764439792635306,130.0,47,48
7,10,100,True,50.0,0.06554002314175626,,78,22
7,10,100,False,42.0,0.019826698619678385,45.550000000000004,59,41
8,0,5,True,56.0,0.0,5.800000000000001,5,0
8,0,5,False,56.0,0.0,5.800000000000001,5,0
8,0,10,True,48.0,0.0,5.800000000000001,10,0
8,0,10,False,52.0,0.0,5.800000000000001,10,0
8,0,15,True,56.0,0.0,5.800000000000001,15,0
8,0,15,False,47.0,0.0,5.800000000000001,15,0
8,0,20,True,54.0,0.0,5.800000000000001,20,0
8,0,20,False,59.0,0.0,5.800000000000001,20,0
8,0,25,True,50.0,0.0,5.800000000000001,25,0
8,0,25,False,44.0,5.479574802957108e-05,50.400000000000006,0,25
8,0,30,True,56.0,0.0,5.800000000000001,30,0
8,0,30,False,96.0,0.11017088974889203,138.0,15,15
8,0,35,True,56.0,0.0,5.800000000000001,35,0
8,0,35,False,97.0,0.12102961049754703,105.25,17,18
8,0,40,True,56.0,0.0,5.800000000000001,40,0
8,0,40,False,98.0,0.14288564348022909,124.10000000000001,20,20
8,0,45,True,50.0,0.0,5.800000000000001,45,0
8,0,45,False,98.0,0.15249573295090998,72.2,22,23
8,0,50,True,53.0,0.0,5.800000000000001,50,0
8,0,50,False,97.0,0.1797571809194196,41.6,25,25
8,0,55,True,53.0,0.09259546784358315,155.75,28,27
8,0,55,False,40.0,0.22215398850581744,93.95,27,28
8,0,60,True,48.0,3.888360590141571e-05,106.15,60,0
8,0,60,False,98.0,0.20622931231411704,131.6,30,30
8,0,65,True,57.0,0.002957593518820147,161.10000000000002,33,32
8,0,65,False,98.0,0.20439287379879664,203.10000000000002,33,32
8,0,70,True,44.0,0.05029836951847268,175.65,39,31
8,0,70,False,55.0,0.19552869106840257,87.60000000000001,35,35
8,0,75,True,57.0,0.0002296922488088347,111.2,28,47
8,0,75,False,96.0,0.21004318304669511,212.85000000000002,37,38
8,0,80,True,60.0,0.00010412429922722176,95.9,80,0
8,0,80,False,99.0,0.2323714879973298,91.7,40,40
8,0,85,True,51.0,0.003269794281207897,86.55000000000001,23,62
8,0,85,False,98.0,0.22607643683229608,126.4,43,42
8,0,90,True,51.0,0.06120298579736803,188.5,61,29
8,0,90,False,98.0,0.2301112291532604,124.10000000000001,45,45
8,0,95,True,48.0,0.0005395569425818244,92.15,1,94
8,0,95,False,98.0,0.20762878895425535,82.65,47,48
8,0,100,True,50.0,0.0006597046936662958,105.25,91,9
8,0,100,False,98.0,0.21153553147356022,198.9,50,50
8,1,5,True,50.0,0.0,5.800000000000001,5,0
8,1,5,False,52.0,0.0,5.800000000000001,5,0
8,1,10,True,56.0,0.0,5.800000000000001,10,0
8,1,10,False,54.0,0.0,5.800000000000001,10,0
8,1,15,True,52.0,0.0,5.800000000000001,15,0
8,1,15,False,60.0,0.0,5.800000000000001,15,0
8,1,20,True,57.0,0.0,5.800000000000001,20,0
8,1,20,False,49.0,0.0,5.800000000000001,20,0
8,1,25,True,49.0,0.0,5.800000000000001,25,0
8,1,25,False,97.0,0.07761161895383172,63.6,12,13
8,1,30,True,50.0,0.0,5.800000000000001,30,0
8,1,30,False,97.0,0.10532850603346629,71.9,15,15
8,1,35,True,53.0,0.0,5.800000000000001,35,0
8,1,35,False,98.0,0.12280516103226669,,17,18
8,1,40,True,54.0,0.0,5.800000000000001,40,0
8,1,40,False,98.0,0.1450445937387869,189.20000000000002,20,20
8,1,45,True,58.0,0.0,5.800000000000001,45,0
8,1,45,False,59.0,0.1560398135975322,74.45,22,23
8,1,50,True,59.0,0.0,5.800000000000001,50,0
8,1,50,False,46.0,0.14735293987047865,81.7,29,21
8,1,55,True,50.0,0.0,5.800000000000001,55,0
8,1,55,False,52.0,0.1737526599214405,73.75,34,21
8,1,60,True,55.0,0.0,5.800000000000001,60,0
8,1,60,False,43.0,0.16112976052715974,120.9,35,25
8,1,65,True,59.0,0.0,5.800000000000001,65,0
8,1,65,False,47.0,0.16131243987373164,79.2,39,26
8,1,70,True,65.0,0.0,5.800000000000001,70,0
8,1,70,False,46.0,0.16842614754003304,153.95000000000002,39,31
8,1,75,True,45.0,0.0,5.800000000000001,75,0
8,1,75,False,46.0,0.17084331319850468,58.0,44,31
8,1,80,True,60.0,0.0,5.800000000000001,80,0
8,1,80,False,44.0,0.18690066060653926,108.15,45,35
8,1,85,True,52.0,0.0,5.800000000000001,85,0
8,1,85,False,42.0,0.1786424490717989,207.0,45,40
8,1,90,True,51.0,0.0,5.800000000000001,90,0
8,1,90,False,47.0,0.2053467024209472,71.60000000000001,47,43
8,1,95,True,62.0,0.0,5.800000000000001,95,0
8,1,95,False,48.0,0.20647657415092244,204.35000000000002,48,47
8,1,100,True,60.0,0.0,5.800000000000001,100,0
8,1,100,False,100.0,0.2228374410010008,68.10000000000001,50,50
8,2,5,True,50.0,0.0,5.800000000000001,5,0
8,2,5,False,65.0,0.0,5.800000000000001,5,0
8,2,10,True,59.0,0.0,5.800000000000001,10,0
8,2,10,False,54.0,0.0,5.800000000000001,10,0
8,2,15,True,55.0,0.0,5.800000000000001,15,0
8,2,15,False,53.0,0.0,5.800000000000001,15,0
8,2,20,True,48.0,0.0,5.800000000000001,20,0
8,2,20,False,55.0,0.0,5.800000000000001,20,0
8,2,25,True,52.0,0.0,5.800000000000001,25,0
8,2,25,False,98.0,0.07604384851432783,57.150000000000006,12,13
8,2,30,True,57.0,0.0,5.800000000000001,30,0
8,2,30,False,98.0,0.11000924052201738,102.4,15,15
8,2,35,True,55.0,0.0,5.800000000000001,35,0
8,2,35,False,96.0,0.12597562650025762,85.2,17,18
8,2,40,True,50.0,0.01569837827033452,,20,20
8,2,40,False,98.0,0.16396076397977666,99.85000000000001,20,20
8,2,45,True,53.0,0.011670111331248017,,23,22
8,2,45,False,97.0,0.1640659359349941,126.4,22,23
8,2,50,True,55.0,0.0,5.800000000000001,50,0
8,2,50,False,100.0,0.1784816498177877,102.30000000000001,25,25
8,2,55,True,56.0,0.0,5.800000000000001,55,0
8,2,55,False,100.0,0.17742544171920782,163.65,28,27
8,2,60,True,66.0,0.0,5.800000000000001,60,0
8,2,60,False,100.0,0.187361619023883,127.4,30,30
8,2,65,True,49.0,0.0,5.800000000000001,65,0
8,2,65,False,100.0,0.1874580251032254,130.35,33,32
8,2,70,True,56.0,0.0,5.800000000000001,70,0
8,2,70,False,100.0,0.19991570547946236,102.95,35,35
8,2,75,True,47.0,0.0,5.800000000000001,75,0
8,2,75,False,100.0,0.2001002799669661,133.6,37,38
8,2,80,True,46.0,0.0,5.800000000000001,80,0
8,2,80,False,100.0,0.2066940676174881,99.80000000000001,40,40
8,2,85,True,56.0,0.0,5.800000000000001,85,0
8,2,85,False,100.0,0.20486187696211705,99.9,42,43
8,2,90,True,46.0,0.0,5.800000000000001,90,0
8,2,90,False,100.0,0.2130885219614838,114.45,45,45
8,2,95,True,50.0,0.0,5.800000000000001,95,0
8,2,95,False,99.0,0.21538678713185533,132.9,48,47
8,2,100,True,59.0,0.0,5.800000000000001,100,0
8,2,100,False,100.0,0.21666017268094603,100.80000000000001,50,50
8,3,5,True,50.0,0.0,5.800000000000001,5,0
8,3,5,False,60.0,0.0,5.800000000000001,5,0
8,3,10,True,55.0,0.0,5.800000000000001,10,0
8,3,10,False,50.0,0.0,5.800000000000001,10,0
8,3,15,True,48.0,0.0,5.800000000000001,15,0
8,3,15,False,62.0,0.0,5.800000000000001,15,0
8,3,20,True,56.0,0.0,5.800000000000001,20,0
8,3,20,False,64.0,0.0,5.800000000000001,20,0
8,3,25,True,56.0,0.0,5.800000000000001,25,0
8,3,25,False,98.0,0.07474914494182117,118.05000000000001,12,13
8,3,30,True,54.0,0.0,5.800000000000001,30,0
8,3,30,False,97.0,0.10933065571469157,80.75,15,15
8,3,35,True,60.0,0.0024368267513639264,165.95000000000002,18,17
8,3,35,False,56.0,0.013141462071217032,164.60000000000002,0,35
8,3,40,True,56.0,0.0005536201449356611,112.10000000000001,20,20
8,3,40,False,98.0,0.1472331127370527,156.70000000000002,20,20
8,3,45,True,51.0,0.0024735628034981126,165.15,23,22
8,3,45,False,99.0,0.14458659765805973,84.80000000000001,23,22
8,3,50,True,59.0,0.010336381001096375,191.35000000000002,25,25
8,3,50,False,96.0,0.16028811761161238,109.85000000000001,25,25
8,3,55,True,47.0,0.0037063353425687427,138.4,27,28
8,3,55,False,100.0,0.24378979808306625,148.20000000000002,27,28
8,3,60,True,55.0,0.1086736413910846,52.0,30,30
8,3,60,False,48.0,0.0032015395256302422,199.70000000000002,0,60
8,3,65,True,60.0,0.017933144618043108,202.20000000000002,32,33
8,3,65,False,48.0,0.004142323016511117,226.25,0,65
8,3,70,True,54.0,0.14122678606167496,240.15,35,35
8,3,70,False,52.0,0.06742161236976005,66.9,70,0
8,3,75,True,47.0,0.06191180992342434,151.65,42,33
8,3,75,False,98.0,0.209050512474168,136.65,38,37
8,3,80,True,55.0,0.006320168098169957,102.80000000000001,5,75
8,3,80,False,85.0,0.20200808792831218,12.700000000000001,40,40
8,3,85,True,53.0,0.012215465332901337,146.05,47,38
8,3,85,False,54.0,0.05917232129816461,176.85000000000002,43,42
8,3,90,True,43.0,0.057319789761281686,145.35,45,45
8,3,90,False,100.0,0.2365386918001908,151.25,45,45
8,3,95,True,61.0,0.04372766612509361,333.55,47,48
8,3,95,False,100.0,0.21852490265365349,86.2,48,47
8,3,100,True,57.0,0.11277860668696264,,50,50
8,3,100,False,61.0,0.19670641609004627,,50,50
8,4,5,True,54.0,0.0,5.800000000000001,5,0
8,4,5,False,48.0,0.0,5.800000000000001,5,0
8,4,10,True,55.0,0.0,5.800000000000001,10,0
8,4,10,False,56.0,0.0,5.800000000000001,10,0
8,4,15,True,54.0,0.0,5.800000000000001,15,0
8,4,15,False,45.0,0.0,5.800000000000001,15,0
8,4,20,True,56.0,0.0,5.800000000000001,20,0
8,4,20,False,58.0,0.0,5.800000000000001,20,0
8,4,25,True,55.0,0.0,5.800000000000001,25,0
8,4,25,False,98.0,0.07482229459181586,129.15,13,12
8,4,30,True,50.0,0.0,5.800000000000001,30,0
8,4,30,False,98.0,0.11892801583357517,100.25,15,15
8,4,35,True,49.0,0.0,5.800000000000001,35,0
8,4,35,False,95.0,0.1287604148004566,147.5,18,17
8,4,40,True,58.0,0.0,5.800000000000001,40,0
8,4,40,False,94.0,0.14088102185057658,62.050000000000004,20,20
8,4,45,True,49.0,0.0,5.800000000000001,45,0
8,4,45,False,97.0,0.15594196447862438,82.80000000000001,22,23
8,4,50,True,53.0,0.0,5.800000000000001,50,0
8,4,50,False,100.0,0.19515816483264367,213.05,25,25
8,4,55,True,55.0,0.0,5.800000000000001,55,0
8,4,55,False,48.0,0.06466207559388575,,54,1
8,4,60,True,56.0,0.0005831097933956534,109.45,22,38
8,4,60,False,45.0,0.07537920932379291,54.95,30,30
8,4,65,True,62.0,3.380292317377461e-05,179.8,0,65
8,4,65,False,48.0,0.03614366995531591,,62,3
8,4,70,True,48.0,0.00079926433928671,,1,69
8,4,70,False,46.0,0.0815417307050583,,49,21
8,4,75,True,61.0,0.022909214524202796,32.9,37,38
8,4,75,False,100.0,0.22906237866530382,64.95,38,37
8,4,80,True,54.0,0.005213621811850408,221.95000000000002,40,40
8,4,80,False,100.0,0.23082966906531793,140.20000000000002,40,40
8,4,85,True,54.0,0.001975867387300185,234.85000000000002,7,78
8,4,85,False,99.0,0.2146647615148488,107.75,42,43
8,4,90,True,61.0,0.005951065402048671,239.45000000000002,45,45
8,4,90,False,99.0,0.21654014866439508,109.15,45,45
8,4,95,True,64.0,0.0019990105200501356,170.8,45,50
8,4,95,False,94.0,0.2061798926036035,,47,48
8,4,100,True,50.0,0.14790019839622295,45.150000000000006,51,49
8,4,100,False,48.0,0.22734835514395207,33.95,50,50
8,5,5,True,57.0,0.0,5.800000000000001,5,0
8,5,5,False,62.0,0.0,5.800000000000001,5,0
8,5,10,True,51.0,0.0,5.800000000000001,10,0
8,5,10,False,49.0,0.0,5.800000000000001,10,0
8,5,15,True,53.0,0.0,5.800000000000001,15,0
8,5,15,False,58.0,0.0,5.800000000000001,15,0
8,5,20,True,56.0,0.0,5.800000000000001,20,0
8,5,20,False,59.0,0.0,5.800000000000001,20,0
8,5,25,True,59.0,0.0,5.800000000000001,25,0
8,5,25,False,97.0,0.0765757912222847,74.95,12,13
8,5,30,True,55.0,0.0,5.800000000000001,30,0
8,5,30,False,98.0,0.10392031170849507,58.300000000000004,15,15
8,5,35,True,41.0,0.0,5.800000000000001,35,0
8,5,35,False,97.0,0.11691349465864863,165.35000000000002,17,18
8,5,40,True,56.0,0.0,5.800000000000001,40,0
8,5,40,False,100.0,0.1692106741656719,225.05,20,20
8,5,45,True,54.0,0.0,5.800000000000001,45,0
8,5,45,False,100.0,0.15428310041167742,,22,23
8,5,50,True,47.0,9.998268693528254e-06,33.85,47,3
8,5,50,False,100.0,0.1770778631636811,131.65,25,25
8,5,55,True,56.0,0.0011116989326581059,53.550000000000004,36,19
8,5,55,False,62.0,0.005245096170526,146.45000000000002,1,54
8,5,60,True,64.0,0.0027761077717955176,16.6,30,30
8,5,60,False,48.0,0.035166630802155256,53.7,0,60
8,5,65,True,47.0,0.0006245746743231392,200.55,0,65
8,5,65,False,68.0,0.11930700415437955,66.3,32,33
8,5,70,True,58.0,0.0028613853617687084,217.20000000000002,35,35
8,5,70,False,52.0,0.05799119088998306,67.2,70,0
8,5,75,True,56.0,0.0008584690482844695,122.5,1,74
8,5,75,False,100.0,0.21619979934670971,133.55,37,38
8,5,80,True,58.0,0.017323573017230125,,40,40
8,5,80,False,100.0,0.2450334770869686,57.1,40,40
8,5,85,True,50.0,0.00241427615040592,119.45,1,84
8,5,85,False,99.0,0.21413483893512486,131.75,42,43
8,5,90,True,45.0,0.0014519469979695661,62.95,5,85
8,5,90,False,99.0,0.22928490816880856,62.650000000000006,47,43
8,5,95,True,63.0,0.0013891523461687916,126.25,13,82
8,5,95,False,56.0,0.10455947162076124,190.25,94,1
8,5,100,True,52.0,0.12149916035434147,56.300000000000004,59,41
8,5,100,False,48.0,0.21663046098447594,59.800000000000004,50,50
8,6,5,True,54.0,0.0,5.800000000000001,5,0
8,6,5,False,46.0,0.0,5.800000000000001,5,0
8,6,10,True,57.0,0.0,5.800000000000001,10,0
8,6,10,False,59.0,0.0,5.800000000000001,10,0
8,6,15,True,58.0,0.0,5.800000000000001,15,0
8,6,15,False,52.0,0.0,5.800000000000001,15,0
8,6,20,True,48.0,0.0,5.800000000000001,20,0
8,6,20,False,45.0,0.0,5.800000000000001,20,0
8,6,25,True,52.0,0.0,5.800000000000001,25,0
8,6,25,False,99.0,0.08003732242017865,105.25,13,12
8,6,30,True,54.0,0.0,5.800000000000001,30,0
8,6,30,False,96.0,0.10331939187006857,87.65,15,15
8,6,35,True,62.0,0.0,5.800000000000001,35,0
8,6,35,False,99.0,0.12894270839260438,108.85000000000001,18,17
8,6,40,True,49.0,0.0,5.800000000000001,40,0
8,6,40,False,100.0,0.15430113551142602,,20,20
8,6,45,True,49.0,0.00010641245952608419,2.15,22,23
8,6,45,False,100.0,0.20089145391559238,138.5,22,23
8,6,50,True,48.0,0.00038858611693471805,7.5,0,50
8,6,50,False,60.0,0.06809465043157338,49.050000000000004,0,50
8,6,55,True,52.0,0.0066646882389092875,,27,28
8,6,55,False,100.0,0.18301102334872735,131.9,27,28
8,6,60,True,57.0,0.0041022238992076245,40.75,14,46
8,6,60,False,45.0,0.20300312590937233,80.9,30,30
8,6,65,True,67.0,0.10684499586043482,333.40000000000003,33,32
8,6,65,False,45.0,0.05792094751230937,,33,32
8,6,70,True,63.0,0.017550323377504926,298.6,31,39
8,6,70,False,99.0,0.21031419000163862,158.20000000000002,35,35
8,6,75,True,54.0,0.04971876879797106,67.0,37,38
8,6,75,False,99.0,0.2069002069834177,278.25,38,37
8,6,80,True,55.0,0.10416425474369374,16.55,40,40
8,6,80,False,51.0,0.08902114534508226,107.55000000000001,40,40
8,6,85,True,53.0,0.11540715235322345,,42,43
8,6,85,False,57.0,0.005127173422014708,170.25,1,84
8,6,90,True,59.0,0.05143471100455208,288.5,45,45
8,6,90,False,100.0,0.22100041190763886,100.15,45,45
8,6,95,True,57.0,0.053676300738812285,74.35000000000001,48,47
8,6,95,False,98.0,0.22826934233713939,105.05000000000001,49,46
8,6,100,True,44.0,0.10140672289885913,218.35000000000002,34,66
8,6,100,False,48.0,0.18630270007931662,,50,50
8,7,5,True,64.0,0.0,5.800000000000001,5,0
8,7,5,False,51.0,0.0,5.800000000000001,5,0
8,7,10,True,48.0,0.0,5.800000000000001,10,0
8,7,10,False,60.0,0.0,5.800000000000001,10,0
8,7,15,True,55.0,0.0,5.800000000000001,15,0
8,7,15,False,51.0,0.0,5.800000000000001,15,0
8,7,20,True,55.0,0.0,5.800000000000001,20,0
8,7,20,False,50.0,0.0002844795579170729,97.30000000000001,5,15
8,7,25,True,63.0,0.0,5.800000000000001,25,0
8,7,25,False,98.0,0.0818704554151315,99.65,12,13
8,7,30,True,60.0,0.0,5.800000000000001,30,0
8,7,30,False,99.0,0.10861957665769656,52.7,15,15
8,7,35,True,56.0,0.0,5.800000000000001,35,0
8,7,35,False,99.0,0.12675092151352277,333.5,17,18
8,7,40,True,51.0,0.00036941454112607774,26.05,22,18
8,7,40,False,98.0,0.15424256743470385,89.5,20,20
8,7,45,True,54.0,7.431342950337428e-05,,34,11
8,7,45,False,47.0,0.01840354234979978,,44,1
8,7,50,True,58.0,0.0005832200852695544,33.45,44,6
8,7,50,False,100.0,0.18736172611100124,99.75,25,25
8,7,55,True,57.0,0.00490172419762459,203.65,27,28
8,7,55,False,93.0,0.23039227112352403,65.3,27,28
8,7,60,True,48.0,0.0003706289809397264,,46,14
8,7,60,False,40.0,0.0633943147669656,71.5,30,30
8,7,65,True,54.0,0.04820733151244026,239.60000000000002,33,32
8,7,65,False,100.0,0.1893374043167949,106.0,32,33
8,7,70,True,54.0,0.03276339898936012,218.15,35,35
8,7,70,False,100.0,0.19827421755224203,135.45000000000002,35,35
8,7,75,True,84.0,0.14811826116751248,182.05,38,37
8,7,75,False,97.0,0.19336728874594405,157.85000000000002,37,38
8,7,80,True,81.0,0.16287550160188913,82.60000000000001,40,40
8,7,80,False,100.0,0.21913810762005573,98.9,40,40
8,7,85,True,76.0,0.13290974379955053,,43,42
8,7,85,False,98.0,0.2262297518182072,48.85,42,43
8,7,90,True,61.0,0.0721600621067223,,46,44
8,7,90,False,100.0,0.23491774217230244,149.85,45,45
8,7,95,True,58.0,0.014588502558861263,,51,44
8,7,95,False,46.0,0.22140844260546969,127.0,47,48
8,7,100,True,40.0,0.01705866705011145,38.650000000000006,1,99
8,7,100,False,42.0,0.12428369757042672,182.3,48,52
8,8,5,True,55.0,0.0,5.800000000000001,5,0
8,8,5,False,55.0,0.0,5.800000000000001,5,0
8,8,10,True,57.0,0.0,5.800000000000001,10,0
8,8,10,False,45.0,0.0,5.800000000000001,10,0
8,8,15,True,56.0,0.0,5.800000000000001,15,0
8,8,15,False,54.0,0.0,5.800000000000001,15,0
8,8,20,True,52.0,0.0,5.800000000000001,20,0
8,8,20,False,53.0,0.0,5.800000000000001,20,0
8,8,25,True,53.0,0.0,5.800000000000001,25,0
8,8,25,False,100.0,0.08196447323745619,,12,13
8,8,30,True,58.0,0.0,5.800000000000001,30,0
8,8,30,False,99.0,0.10403096392187829,59.2,15,15
8,8,35,True,48.0,0.0,5.800000000000001,35,0
8,8,35,False,99.0,0.13981474695190674,319.3,17,18
8,8,40,True,56.0,0.0,5.800000000000001,40,0
8,8,40,False,100.0,0.13779510625596325,139.55,20,20
8,8,45,True,57.0,0.0002323293273854744,,16,29
8,8,45,False,100.0,0.1577878668570569,105.7,22,23
8,8,50,True,50.0,6.783958948574552e-05,221.95000000000002,39,11
8,8,50,False,100.0,0.17683120992675277,146.45000000000002,25,25
8,8,55,True,57.0,0.00032510199632636587,,13,42
8,8,55,False,99.0,0.16357127978630473,84.0,27,28
8,8,60,True,71.0,0.08659849926659613,328.35,30,30
8,8,60,False,98.0,0.17673645811424515,104.85000000000001,30,30
8,8,65,True,70.0,0.12172752995077867,16.25,33,32
8,8,65,False,52.0,0.0027334757755410914,45.550000000000004,0,65
8,8,70,True,88.0,0.16578044747594328,,35,35
8,8,70,False,97.0,0.19815343124735305,75.75,35,35
8,8,75,True,92.0,0.15701941999344574,57.6,38,37
8,8,75,False,100.0,0.21651583821193765,134.4,37,38
8,8,80,True,86.0,0.13923582357786485,139.25,41,39
8,8,80,False,98.0,0.21493007544543738,111.65,40,40
8,8,85,True,79.0,0.14787388494299933,196.75,44,41
8,8,85,False,99.0,0.2153118786376892,102.4,42,43
8,8,90,True,78.0,0.11444524300666617,,47,43
8,8,90,False,100.0,0.24047289418998125,265.55,45,45
8,8,95,True,68.0,0.0994737501351643,,48,47
8,8,95,False,97.0,0.22149291707430413,136.55,48,47
8,8,100,True,44.0,0.020372844396119253,19.150000000000002,75,25
8,8,100,False,44.0,0.1296996504148766,,49,51
8,9,5,True,55.0,0.0,5.800000000000001,5,0
8,9,5,False,61.0,0.0,5.800000000000001,5,0
8,9,10,True,61.0,0.0,5.800000000000001,10,0
8,9,10,False,53.0,0.0,5.800000000000001,10,0
8,9,15,True,56.0,0.0,5.800000000000001,15,0
8,9,15,False,54.0,0.0,5.800000000000001,15,0
8,9,20,True,53.0,0.0,5.800000000000001,20,0
8,9,20,False,51.0,0.00030091251897528687,97.30000000000001,7,13
8,9,25,True,50.0,0.0,5.800000000000001,25,0
8,9,25,False,95.0,0.08456464631388318,161.3,12,13
8,9,30,True,44.0,0.0,5.800000000000001,30,0
8,9,30,False,99.0,0.105497912725896,104.7,15,15
8,9,35,True,52.0,0.0,5.800000000000001,35,0
8,9,35,False,100.0,0.12673895954587214,146.65,17,18
8,9,40,True,58.0,0.0,5.800000000000001,40,0
8,9,40,False,100.0,0.15675223962971527,104.9,20,20
8,9,45,True,52.0,7.376687680381807e-06,33.85,37,8
8,9,45,False,100.0,0.17549953370710847,98.9,22,23
8,9,50,True,46.0,0.001136410436887324,49.0,12,38
8,9,50,False,100.0,0.18176705712705984,145.3,25,25
8,9,55,True,74.0,0.059713401068354835,26.650000000000002,28,27
8,9,55,False,100.0,0.17665759900555275,100.2,28,27
8,9,60,True,74.0,0.12774847630795033,,30,30
8,9,60,False,99.0,0.18084597549111675,96.10000000000001,30,30
8,9,65,True,87.0,0.13684850277006883,41.800000000000004,33,32
8,9,65,False,95.0,0.18503224676095745,97.10000000000001,32,33
8,9,70,True,85.0,0.14925741753918687,171.35000000000002,35,35
8,9,70,False,57.0,0.014955623826514742,,70,0
8,9,75,True,84.0,0.15084968710983485,192.65,38,37
8,9,75,False,100.0,0.23034545387519587,164.15,37,38
8,9,80,True,85.0,0.16166673031547044,150.45000000000002,40,40
8,9,80,False,100.0,0.24148290647007126,169.3,40,40
8,9,85,True,87.0,0.15231376267595187,,43,42
8,9,85,False,98.0,0.21100404583240812,102.10000000000001,42,43
8,9,90,True,78.0,0.13207188534994768,228.0,48,42
8,9,90,False,99.0,0.22453281672109607,137.1,45,45
8,9,95,True,68.0,0.13239218845398976,132.6,49,46
8,9,95,False,98.0,0.22858348212186616,99.30000000000001,49,46
8,9,100,True,44.0,0.03358743887525339,,65,35
8,9,100,False,56.0,0.09230722203621619,259.15000000000003,93,7
8,10,5,True,56.0,0.0,5.800000000000001,5,0
8,10,5,False,61.0,0.0,5.800000000000001,5,0
8,10,10,True,47.0,0.0,5.800000000000001,10,0
8,10,10,False,44.0,0.0,5.800000000000001,10,0
8,10,15,True,54.0,0.0,5.800000000000001,15,0
8,10,15,False,60.0,0.0,5.800000000000001,15,0
8,10,20,True,59.0,0.0,5.800000000000001,20,0
8,10,20,False,49.0,0.0,5.800000000000001,20,0
8,10,25,True,62.0,0.0,5.800000000000001,25,0
8,10,25,False,99.0,0.07832044271970874,167.0,12,13
8,10,30,True,57.0,0.0,5.800000000000001,30,0
8,10,30,False,100.0,0.10895975441982056,135.1,15,15
8,10,35,True,56.0,0.0,5.800000000000001,35,0
8,10,35,False,100.0,0.12467689679075761,55.5,17,18
8,10,40,True,57.0,0.0,5.800000000000001,40,0
8,10,40,False,100.0,0.19829775831828855,63.900000000000006,20,20
8,10,45,True,56.0,0.00016552072811995783,156.75,13,32
8,10,45,False,100.0,0.1556094295764528,83.85000000000001,22,23
8,10,50,True,73.0,0.10385093041206034,,25,25
8,10,50,False,100.0,0.18948385278086474,90.10000000000001,25,25
8,10,55,True,75.0,0.12108991797318883,51.25,27,28
8,10,55,False,48.0,0.057372962564273794,,55,0
8,10,60,True,89.0,0.1506623293322813,167.60000000000002,30,30
8,10,60,False,95.0,0.17934520011088345,171.15,30,30
8,10,65,True,56.0,0.000485174399658584,81.10000000000001,49,16
8,10,65,False,54.0,0.006279808186305653,157.60000000000002,1,64
8,10,70,True,87.0,0.156897801858641,,35,35
8,10,70,False,92.0,0.18915295970363932,139.9,35,35
8,10,75,True,82.0,0.1504339183710275,217.10000000000002,38,37
8,10,75,False,98.0,0.19808624277882733,100.80000000000001,37,38
8,10,80,True,86.0,0.16575278444629918,,40,40
8,10,80,False,97.0,0.20163632175304522,231.65,40,40
8,10,85,True,92.0,0.17882362592442272,,42,43
8,10,85,False,98.0,0.20769939861484163,109.95,42,43
8,10,90,True,90.0,0.17923371393495,,45,45
8,10,90,False,99.0,0.21692956968415103,199.25,45,45
8,10,95,True,89.0,0.1774382304126747,135.75,48,47
8,10,95,False,100.0,0.23498262077141738,64.05,48,47
8,10,100,True,47.0,0.0028202776173015327,,100,0
8,10,100,False,46.0,0.11323983065616107,280.05,54,46
9,0,5,True,61.0,0.0,5.800000000000001,5,0
9,0,5,False,52.0,0.0,5.800000000000001,5,0
9,0,10,True,57.0,0.0,5.800000000000001,10,0
9,0,10,False,49.0,0.0,5.800000000000001,10,0
9,0,15,True,53.0,0.0,5.800000000000001,15,0
9,0,15,False,59.0,0.0,5.800000000000001,15,0
9,0,20,True,53.0,0.0,5.800000000000001,20,0
9,0,20,False,55.0,0.0,5.800000000000001,20,0
9,0,25,True,52.0,0.0,5.800000000000001,25,0
9,0,25,False,98.0,0.08010859413496507,89.30000000000001,12,13
9,0,30,True,57.0,0.0,5.800000000000001,30,0
9,0,30,False,98.0,0.10483018538699326,138.8,15,15
9,0,35,True,49.0,0.0,5.800000000000001,35,0
9,0,35,False,98.0,0.12008400993206489,87.85000000000001,18,17
9,0,40,True,45.0,0.0,5.800000000000001,40,0
9,0,40,False,98.0,0.14169063648245162,155.25,20,20
9,0,45,True,53.0,0.0,5.800000000000001,45,0
9,0,45,False,98.0,0.15485598093278322,173.70000000000002,22,23
9,0,50,True,52.0,0.0,5.800000000000001,50,0
9,0,50,False,97.0,0.17734887000880173,,25,25
9,0,55,True,41.0,0.10620504817478175,,28,27
9,0,55,False,100.0,0.23285321340761572,132.70000000000002,27,28
9,0,60,True,59.0,0.0031884984283386533,195.75,30,30
9,0,60,False,98.0,0.23497386567228795,117.55000000000001,30,30
9,0,65,True,51.0,0.0019065526630629647,163.65,33,32
9,0,65,False,98.0,0.20145046633822045,149.0,32,33
9,0,70,True,62.0,0.0014360325606776966,161.5,35,35
9,0,70,False,95.0,0.23247713053189645,,35,35
9,0,75,True,50.0,0.0003503061175980502,127.15,52,23
9,0,75,False,98.0,0.22424886183974096,131.70000000000002,37,38
9,0,80,True,54.0,0.00972372968388508,,11,69
9,0,80,False,99.0,0.2323636190826195,47.900000000000006,40,40
9,0,85,True,48.0,0.007456375890802769,111.5,43,42
9,0,85,False,96.0,0.23125404066628472,106.15,42,43
9,0,90,True,48.0,0.000147882890984398,124.25,90,0
9,0,90,False,98.0,0.18880936330162842,124.65,34,56
9,0,95,True,51.0,0.0005118392834815371,163.65,49,46
9,0,95,False,99.0,0.20781870280115655,103.7,47,48
9,0,100,True,51.0,0.00015002506267772434,126.4,61,39
9,0,100,False,99.0,0.22857147143011988,160.5,50,50
9,1,5,True,59.0,0.0,5.800000000000001,5,0
9,1,5,False,66.0,0.0,5.800000000000001,5,0
9,1,10,True,58.0,0.0,5.800000000000001,10,0
9,1,10,False,53.0,0.0,5.800000000000001,10,0
9,1,15,True,45.0,0.0,5.800000000000001,15,0
9,1,15,False,58.0,0.0,5.800000000000001,15,0
9,1,20,True,54.0,0.0,5.800000000000001,20,0
9,1,20,False,51.0,0.0,5.800000000000001,20,0
9,1,25,True,51.0,0.0,5.800000000000001,25,0
9,1,25,False,98.0,0.07794570869395469,124.35000000000001,12,13
9,1,30,True,64.0,0.0,5.800000000000001,30,0
9,1,30,False,98.0,0.10863443056721837,52.800000000000004,15,15
9,1,35,True,56.0,0.0,5.800000000000001,35,0
9,1,35,False,98.0,0.11966254626993077,223.35000000000002,18,17
9,1,40,True,52.0,0.0,5.800000000000001,40,0
9,1,40,False,97.0,0.1464271161624194,60.75,20,20
9,1,45,True,49.0,0.0,5.800000000000001,45,0
9,1,45,False,57.0,0.15948637093912016,94.60000000000001,22,23
9,1,50,True,50.0,0.0,5.800000000000001,50,0
9,1,50,False,49.0,0.15796133982194688,98.35000000000001,29,21
9,1,55,True,52.0,0.0,5.800000000000001,55,0
9,1,55,False,53.0,0.16405813156376592,129.75,33,22
9,1,60,True,48.0,0.0,5.800000000000001,60,0
9,1,60,False,55.0,0.16463001760216253,40.85,35,25
9,1,65,True,52.0,0.0,5.800000000000001,65,0
9,1,65,False,47.0,0.16731921756921578,200.55,38,27
9,1,70,True,46.0,0.0,5.800000000000001,70,0
9,1,70,False,52.0,0.1767786432995125,97.30000000000001,44,26
9,1,75,True,62.0,0.0,5.800000000000001,75,0
9,1,75,False,46.0,0.17294080890410352,217.05,46,29
9,1,80,True,65.0,0.0,5.800000000000001,80,0
9,1,80,False,53.0,0.17194036338387553,123.60000000000001,41,39
9,1,85,True,61.0,0.0,5.800000000000001,85,0
9,1,85,False,50.0,0.1868945747395361,106.85000000000001,49,36
9,1,90,True,57.0,0.0,5.800000000000001,90,0
9,1,90,False,58.0,0.1984816315178961,157.55,45,45
9,1,95,True,50.0,0.0,5.800000000000001,95,0
9,1,95,False,47.0,0.19907901571325845,125.05000000000001,48,47
9,1,100,True,49.0,0.0,5.800000000000001,100,0
9,1,100,False,100.0,0.2245477284596125,60.050000000000004,50,50
9,2,5,True,55.0,0.0,5.800000000000001,5,0
9,2,5,False,46.0,0.0,5.800000000000001,5,0
9,2,10,True,52.0,0.0,5.800000000000001,10,0
9,2,10,False,57.0,0.0,5.800000000000001,10,0
9,2,15,True,61.0,0.0,5.800000000000001,15,0
9,2,15,False,49.0,0.0,5.800000000000001,15,0
9,2,20,True,53.0,0.0,5.800000000000001,20,0
9,2,20,False,57.0,0.0,5.800000000000001,20,0
9,2,25,True,50.0,0.0,5.800000000000001,25,0
9,2,25,False,98.0,0.07741091500513533,165.20000000000002,12,13
9,2,30,True,53.0,0.0,5.800000000000001,30,0
9,2,30,False,98.0,0.10892277547062412,98.2,15,15
9,2,35,True,57.0,0.0,5.800000000000001,35,0
9,2,35,False,97.0,0.12784173172835228,100.55000000000001,17,18
9,2,40,True,51.0,0.0042781872698320084,,20,20
9,2,40,False,100.0,0.15557510430334046,76.0,20,20
9,2,45,True,56.0,0.00294539611185579,208.8,23,22
9,2,45,False,98.0,0.16488093522082986,146.65,23,22
9,2,50,True,59.0,0.00017081873460026228,113.35000000000001,25,25
9,2,50,False,100.0,0.1787068609919305,101.95,25,25
9,2,55,True,46.0,0.0,5.800000000000001,55,0
9,2,55,False,100.0,0.18475881950959538,129.85,28,27
9,2,60,True,57.0,0.0,5.800000000000001,60,0
9,2,60,False,97.0,0.18580259900212287,132.3,30,30
9,2,65,True,51.0,0.0,5.800000000000001,65,0
9,2,65,False,100.0,0.19111699748083186,215.60000000000002,32,33
9,2,70,True,56.0,0.0,5.800000000000001,70,0
9,2,70,False,100.0,0.19605288788481118,98.35000000000001,35,35
9,2,75,True,57.0,0.0,5.800000000000001,75,0
9,2,75,False,100.0,0.20040753287759422,133.35,37,38
9,2,80,True,49.0,0.0,5.800000000000001,80,0
9,2,80,False,100.0,0.20238928082499671,46.85,40,40
9,2,85,True,58.0,0.0,5.800000000000001,85,0
9,2,85,False,100.0,0.2056393886343146,104.7,43,42
9,2,90,True,59.0,0.0,5.800000000000001,90,0
9,2,90,False,100.0,0.21420723785878526,64.9,45,45
9,2,95,True,55.0,0.0,5.800000000000001,95,0
9,2,95,False,100.0,0.21133049818758076,137.95000000000002,48,47
9,2,100,True,55.0,0.0,5.800000000000001,100,0
9,2,100,False,100.0,0.21974098750225948,97.95,50,50
9,3,5,True,63.0,0.0,5.800000000000001,5,0
9,3,5,False,51.0,0.0,5.800000000000001,5,0
9,3,10,True,57.0,0.0,5.800000000000001,10,0
9,3,10,False,62.0,0.0,5.800000000000001,10,0
9,3,15,True,55.0,0.0,5.800000000000001,15,0
9,3,15,False,54.0,0.0,5.800000000000001,15,0
9,3,20,True,57.0,0.0,5.800000000000001,20,0
9,3,20,False,59.0,0.0,5.800000000000001,20,0
9,3,25,True,43.0,0.0,5.800000000000001,25,0
9,3,25,False,97.0,0.07466342708891793,40.900000000000006,13,12
9,3,30,True,54.0,0.0,5.800000000000001,30,0
9,3,30,False,98.0,0.10564147930584665,115.30000000000001,15,15
9,3,35,True,53.0,0.00129871102859062,159.45000000000002,17,18
9,3,35,False,98.0,0.1209583889752553,88.25,17,18
9,3,40,True,45.0,0.003780211126063261,197.60000000000002,20,20
9,3,40,False,97.0,0.15596520406476658,,20,20
9,3,45,True,52.0,0.005065227343671675,141.8,23,22
9,3,45,False,100.0,0.14589648559734048,67.5,23,22
9,3,50,True,47.0,0.00048240828285983574,109.65,4,46
9,3,50,False,98.0,0.18458103735802273,105.9,25,25
9,3,55,True,53.0,0.0023738989058076534,134.85,27,28
9,3,55,False,100.0,0.23934282334531154,147.35,27,28
9,3,60,True,48.0,0.01300035938167404,160.9,5,55
9,3,60,False,58.0,0.0016813690329310733,169.75,0,60
9,3,65,True,55.0,0.0463009903947065,,33,32
9,3,65,False,91.0,0.19636607216349922,120.05000000000001,33,32
9,3,70,True,54.0,0.00428044071415526,206.0,24,46
9,3,70,False,49.0,0.034833757953995195,,70,0
9,3,75,True,50.0,0.042996630531458094,92.35000000000001,37,38
9,3,75,False,97.0,0.22049507504666296,110.10000000000001,38,37
9,3,80,True,60.0,0.010975439315167148,97.7,0,80
9,3,80,False,100.0,0.21402407245274088,249.4,40,40
9,3,85,True,62.0,0.011738990702033224,185.75,47,38
9,3,85,False,93.0,0.2095554167337356,183.4,43,42
9,3,90,True,48.0,0.09654393552920772,26.6,45,45
9,3,90,False,88.0,0.21660725239528392,58.95,45,45
9,3,95,True,52.0,0.056123673317442384,169.35000000000002,47,48
9,3,95,False,88.0,0.20605762364737099,237.25,48,47
9,3,100,True,62.0,0.15649731987584012,,50,50
9,3,100,False,60.0,0.17665831900333784,193.20000000000002,50,50
9,4,5,True,50.0,0.0,5.800000000000001,5,0
9,4,5,False,62.0,0.0,5.800000000000001,5,0
9,4,10,True,56.0,0.0,5.800000000000001,10,0
9,4,10,False,52.0,0.0,5.800000000000001,10,0
9,4,15,True,60.0,0.0,5.800000000000001,15,0
9,4,15,False,58.0,0.0,5.800000000000001,15,0
9,4,20,True,54.0,0.0,5.800000000000001,20,0
9,4,20,False,59.0,0.0,5.800000000000001,20,0
9,4,25,True,60.0,0.0,5.800000000000001,25,0
9,4,25,False,98.0,0.07594337184845514,79.7,12,13
9,4,30,True,58.0,0.0,5.800000000000001,30,0
9,4,30,False,99.0,0.10423053995227943,83.80000000000001,15,15
9,4,35,True,53.0,0.0,5.800000000000001,35,0
9,4,35,False,98.0,0.10959551462096644,140.3,18,17
9,4,40,True,49.0,0.0,5.800000000000001,40,0
9,4,40,False,94.0,0.13550972714092954,106.65,20,20
9,4,45,True,53.0,0.0,5.800000000000001,45,0
9,4,45,False,99.0,0.1639776409539927,109.45,22,23
9,4,50,True,55.0,0.0,5.800000000000001,50,0
9,4,50,False,98.0,0.1872928376371981,104.30000000000001,25,25
9,4,55,True,46.0,0.00024040001921377935,28.3,0,55
9,4,55,False,100.0,0.2198088572135984,193.95000000000002,28,27
9,4,60,True,62.0,0.0,5.800000000000001,60,0
9,4,60,False,49.0,0.011885160015598637,52.6,0,60
9,4,65,True,57.0,0.000136864493842057,236.15,1,64
9,4,65,False,49.0,0.03636156613937659,,32,33
9,4,70,True,62.0,0.0014816154264296543,,9,61
9,4,70,False,57.0,0.027933290225909485,15.4,70,0
9,4,75,True,49.0,0.0018002358105285853,105.10000000000001,14,61
9,4,75,False,100.0,0.23955186933436617,137.70000000000002,37,38
9,4,80,True,54.0,0.012522362497345363,,40,40
9,4,80,False,100.0,0.2133956407293354,91.5,40,40
9,4,85,True,57.0,0.010848071210821847,,43,42
9,4,85,False,100.0,0.21924851427205863,53.400000000000006,43,42
9,4,90,True,53.0,0.0022033158357573487,,45,45
9,4,90,False,100.0,0.2193875828156498,98.75,45,45
9,4,95,True,50.0,0.011680159197642183,191.60000000000002,47,48
9,4,95,False,99.0,0.22644961787017898,239.9,49,46
9,4,100,True,43.0,0.17411056428916294,,51,49
9,4,100,False,47.0,0.21779748509204183,101.30000000000001,50,50
9,5,5,True,53.0,0.0,5.800000000000001,5,0
9,5,5,False,53.0,0.0,5.800000000000001,5,0
9,5,10,True,57.0,0.0,5.800000000000001,10,0
9,5,10,False,54.0,0.0,5.800000000000001,10,0
9,5,15,True,54.0,0.0,5.800000000000001,15,0
9,5,15,False,45.0,0.0,5.800000000000001,15,0
9,5,20,True,48.0,0.0,5.800000000000001,20,0
9,5,20,False,57.0,0.0,5.800000000000001,20,0
9,5,25,True,42.0,0.0,5.800000000000001,25,0
9,5,25,False,96.0,0.07867162666318236,64.95,12,13
9,5,30,True,58.0,0.0,5.800000000000001,30,0
9,5,30,False,97.0,0.11899109244825451,86.5,15,15
9,5,35,True,54.0,0.0,5.800000000000001,35,0
9,5,35,False,99.0,0.12405723728867198,101.65,17,18
9,5,40,True,59.0,0.0,5.800000000000001,40,0
9,5,40,False,97.0,0.14638494709112398,135.3,20,20
9,5,45,True,47.0,0.0,5.800000000000001,45,0
9,5,45,False,98.0,0.15168613009927692,189.95000000000002,22,23
9,5,50,True,50.0,1.4230717300485095e-05,32.25,41,9
9,5,50,False,100.0,0.19533828793830418,92.85000000000001,25,25
9,5,55,True,54.0,0.00033216966639899637,54.050000000000004,6,49
9,5,55,False,100.0,0.2428178587918669,70.75,27,28
9,5,60,True,53.0,0.00019136218792860645,126.60000000000001,0,60
9,5,60,False,82.0,0.15264372620615102,62.25,60,0
9,5,65,True,49.0,0.015348009103915532,29.35,31,34
9,5,65,False,53.0,0.00576190394530758,,0,65
9,5,70,True,46.0,0.009820439123884438,234.0,57,13
9,5,70,False,50.0,0.03771117476459274,,70,0
9,5,75,True,62.0,0.008307532672096928,59.6,52,23
9,5,75,False,100.0,0.23566666356042645,108.60000000000001,37,38
9,5,80,True,53.0,0.02078568448357465,265.65000000000003,40,40
9,5,80,False,100.0,0.2196209921104464,215.95000000000002,40,40
9,5,85,True,50.0,0.0019216530126145476,51.85,0,85
9,5,85,False,96.0,0.2110028637634436,95.9,42,43
9,5,90,True,54.0,0.025992447575630642,,32,58
9,5,90,False,58.0,0.16443113275215648,264.85,45,45
9,5,95,True,52.0,0.0015871696991686195,163.35000000000002,29,66
9,5,95,False,100.0,0.24100194693984445,232.20000000000002,47,48
9,5,100,True,45.0,0.13972331507403044,267.1,47,53
9,5,100,False,55.0,0.21221232471942575,84.4,50,50
9,6,5,True,59.0,0.0,5.800000000000001,5,0
9,6,5,False,68.0,0.0,5.800000000000001,5,0
9,6,10,True,50.0,0.0,5.800000000000001,10,0
9,6,10,False,48.0,0.0,5.800000000000001,10,0
9,6,15,True,54.0,0.0,5.800000000000001,15,0
9,6,15,False,51.0,0.0,5.800000000000001,15,0
9,6,20,True,56.0,0.0,5.800000000000001,20,0
9,6,20,False,46.0,0.0,5.800000000000001,20,0
9,6,25,True,53.0,0.0,5.800000000000001,25,0
9,6,25,False,96.0,0.0909123460213506,76.45,12,13
9,6,30,True,55.0,0.0,5.800000000000001,30,0
9,6,30,False,98.0,0.1243233736427433,64.7,15,15
9,6,35,True,53.0,0.0,5.800000000000001,35,0
9,6,35,False,99.0,0.12589678563459172,101.45,17,18
9,6,40,True,48.0,0.0,5.800000000000001,40,0
9,6,40,False,99.0,0.15824858638742206,,20,20
9,6,45,True,52.0,0.0001436291591002439,,37,8
9,6,45,False,100.0,0.1672155133573138,133.85,22,23
9,6,50,True,63.0,0.0009858453924835478,55.85,50,0
9,6,50,False,100.0,0.18763098449767718,93.55000000000001,25,25
9,6,55,True,52.0,0.015522120120963516,297.0,27,28
9,6,55,False,97.0,0.18358327822070047,69.5,27,28
9,6,60,True,57.0,0.00821853130939424,252.5,30,30
9,6,60,False,99.0,0.1925376193867014,100.25,30,30
9,6,65,True,57.0,0.011977908654942412,33.15,25,40
9,6,65,False,100.0,0.2330992186159188,59.650000000000006,32,33
9,6,70,True,69.0,0.08539798682063825,82.30000000000001,35,35
9,6,70,False,43.0,0.11125443389815837,,35,35
9,6,75,True,56.0,0.0868876092359556,101.60000000000001,39,36
9,6,75,False,79.0,0.22056774572338386,,38,37
9,6,80,True,56.0,0.06499904377438989,,40,40
9,6,80,False,100.0,0.22607192249865793,155.05,40,40
9,6,85,True,57.0,0.026940317553815214,,42,43
9,6,85,False,99.0,0.21328337927951627,54.45,43,42
9,6,90,True,57.0,0.10332892660216986,,45,45
9,6,90,False,99.0,0.21654417042334673,100.0,46,44
9,6,95,True,55.0,0.016871808305049908,65.9,47,48
9,6,95,False,99.0,0.22448967173618162,81.7,48,47
9,6,100,True,43.0,0.10296605660174965,125.15,41,59
9,6,100,False,52.0,0.19534043379359367,102.60000000000001,50,50
9,7,5,True,53.0,0.0,5.800000000000001,5,0
9,7,5,False,52.0,0.0,5.800000000000001,5,0
9,7,10,True,50.0,0.0,5.800000000000001,10,0
9,7,10,False,58.0,0.0,5.800000000000001,10,0
9,7,15,True,51.0,0.0,5.800000000000001,15,0
9,7,15,False,55.0,0.0,5.800000000000001,15,0
9,7,20,True,53.0,0.0,5.800000000000001,20,0
9,7,20,False,50.0,0.0,5.800000000000001,20,0
9,7,25,True,52.0,0.0,5.800000000000001,25,0
9,7,25,False,98.0,0.07445861526338296,171.70000000000002,12,13
9,7,30,True,48.0,0.0,5.800000000000001,30,0
9,7,30,False,100.0,0.11751801335164033,79.35000000000001,15,15
9,7,35,True,59.0,0.0,5.800000000000001,35,0
9,7,35,False,100.0,0.13479568006665013,182.15,17,18
9,7,40,True,59.0,0.00015201323823995825,83.5,40,0
9,7,40,False,98.0,0.1544435209658194,78.35000000000001,20,20
9,7,45,True,64.0,0.0026689719934802863,50.7,41,4
9,7,45,False,100.0,0.1784686273824675,91.30000000000001,22,23
9,7,50,True,62.0,0.03339231646803786,244.4,25,25
9,7,50,False,100.0,0.17588308892199167,90.55000000000001,25,25
9,7,55,True,54.0,0.016252229001347537,,28,27
9,7,55,False,43.0,0.006554657607949766,166.05,1,54
9,7,60,True,65.0,0.08779530827687455,,30,30
9,7,60,False,47.0,0.10792447399905294,,30,30
9,7,65,True,46.0,0.0013951086278673475,244.70000000000002,42,23
9,7,65,False,46.0,0.004283098809761067,,0,65
9,7,70,True,42.0,0.007938008946983342,,70,0
9,7,70,False,59.0,0.0030049129588773783,103.75,0,70
9,7,75,True,69.0,0.14974798758221824,306.35,38,37
9,7,75,False,53.0,0.11552132934372901,78.5,1,74
9,7,80,True,77.0,0.13437439125305276,233.25,41,39
9,7,80,False,99.0,0.2225050019333324,98.5,40,40
9,7,85,True,82.0,0.14169729035359496,28.700000000000003,43,42
9,7,85,False,57.0,0.05766679129139996,45.5,85,0
9,7,90,True,66.0,0.10924950238218405,180.25,45,45
9,7,90,False,99.0,0.2375369958960136,132.6,46,44
9,7,95,True,47.0,0.021373945887905983,,22,73
9,7,95,False,68.0,0.22987598480165156,113.85000000000001,55,40
9,7,100,True,49.0,0.02441066283077424,,50,50
9,7,100,False,47.0,0.10987721250216491,,50,50
9,8,5,True,50.0,0.0,5.800000000000001,5,0
9,8,5,False,56.0,0.0,5.800000000000001,5,0
9,8,10,True,56.0,0.0,5.800000000000001,10,0
9,8,10,False,52.0,0.0,5.800000000000001,10,0
9,8,15,True,55.0,0.0,5.800000000000001,15,0
9,8,15,False,52.0,0.0,5.800000000000001,15,0
9,8,20,True,50.0,0.0,5.800000000000001,20,0
9,8,20,False,52.0,0.0,5.800000000000001,20,0
9,8,25,True,51.0,0.0,5.800000000000001,25,0
9,8,25,False,99.0,0.07733272280080498,135.25,12,13
9,8,30,True,59.0,0.0,5.800000000000001,30,0
9,8,30,False,99.0,0.10482532983254884,174.70000000000002,15,15
9,8,35,True,54.0,0.0,5.800000000000001,35,0
9,8,35,False,99.0,0.13266095193182473,181.4,17,18
9,8,40,True,46.0,0.0,5.800000000000001,40,0
9,8,40,False,99.0,0.13849721471780863,34.0,20,20
9,8,45,True,45.0,0.00023205866204733174,,27,18
9,8,45,False,100.0,0.16717574040006616,89.5,22,23
9,8,50,True,51.0,0.0002513541270898795,219.55,26,24
9,8,50,False,59.0,0.004309461979744535,129.9,0,50
9,8,55,True,57.0,0.0020766124284826775,,25,30
9,8,55,False,99.0,0.15794210548675156,94.10000000000001,27,28
9,8,60,True,67.0,0.07575819348404905,99.15,30,30
9,8,60,False,100.0,0.18237240774974567,134.25,30,30
9,8,65,True,76.0,0.12185976246129016,,33,32
9,8,65,False,100.0,0.21343974359595178,69.4,32,33
9,8,70,True,91.0,0.15950921629301337,,35,35
9,8,70,False,97.0,0.19515993465993614,134.20000000000002,35,35
9,8,75,True,90.0,0.1673815567373013,22.150000000000002,38,37
9,8,75,False,100.0,0.20061932732795804,75.25,37,38
9,8,80,True,77.0,0.14712646394800946,293.40000000000003,41,39
9,8,80,False,99.0,0.21352614385070534,139.0,40,40
9,8,85,True,83.0,0.15443318910400297,59.6,44,41
9,8,85,False,99.0,0.22359508674562914,92.35000000000001,42,43
9,8,90,True,73.0,0.10590143564304243,289.2,48,42
9,8,90,False,99.0,0.22469537706135356,63.95,45,45
9,8,95,True,62.0,0.10679650191745199,199.8,49,46
9,8,95,False,100.0,0.22390365015789826,103.5,47,48
9,8,100,True,48.0,0.017370477937272037,315.0,53,47
9,8,100,False,43.0,0.08639971104659198,182.45000000000002,43,57
9,9,5,True,52.0,0.0,5.800000000000001,5,0
9,9,5,False,44.0,0.0,5.800000000000001,5,0
9,9,10,True,55.0,0.0,5.800000000000001,10,0
9,9,10,False,52.0,0.0,5.800000000000001,10,0
9,9,15,True,55.0,0.0,5.800000000000001,15,0
9,9,15,False,55.0,0.0,5.800000000000001,15,0
9,9,20,True,49.0,0.0,5.800000000000001,20,0
9,9,20,False,55.0,0.0,5.800000000000001,20,0
9,9,25,True,53.0,0.0,5.800000000000001,25,0
9,9,25,False,99.0,0.07607901742181312,64.10000000000001,12,13
9,9,30,True,57.0,0.0,5.800000000000001,30,0
9,9,30,False,99.0,0.10403749421406691,147.4,15,15
9,9,35,True,55.0,0.0,5.800000000000001,35,0
9,9,35,False,100.0,0.12032349982831164,53.6,17,18
9,9,40,True,54.0,0.0,5.800000000000001,40,0
9,9,40,False,100.0,0.1511690141939484,82.10000000000001,20,20
9,9,45,True,50.0,2.5129480845812802e-05,,18,27
9,9,45,False,100.0,0.17897997244450717,112.5,22,23
9,9,50,True,54.0,0.001959725978706078,,20,30
9,9,50,False,99.0,0.16129666647024926,136.20000000000002,25,25
9,9,55,True,75.0,0.09097745774229622,,28,27
9,9,55,False,98.0,0.16780224688055717,79.05000000000001,27,28
9,9,60,True,74.0,0.13185266011345,99.60000000000001,30,30
9,9,60,False,50.0,0.0018929189909035534,,0,60
9,9,65,True,87.0,0.14935084051751626,45.550000000000004,33,32
9,9,65,False,96.0,0.18315348670111142,136.1,32,33
9,9,70,True,77.0,0.13982988715862535,213.4,35,35
9,9,70,False,99.0,0.19988778398708099,108.7,35,35
9,9,75,True,92.0,0.1480744971343579,216.4,39,36
9,9,75,False,98.0,0.1930144433131388,86.65,37,38
9,9,80,True,93.0,0.16336361695419704,188.60000000000002,40,40
9,9,80,False,98.0,0.20892158438283204,234.05,40,40
9,9,85,True,80.0,0.15740869801678015,164.5,43,42
9,9,85,False,100.0,0.21864159562665178,,42,43
9,9,90,True,75.0,0.13013361359102982,119.2,47,43
9,9,90,False,57.0,0.11374089067012855,209.55,45,45
9,9,95,True,83.0,0.14107482819406308,171.5,49,46
9,9,95,False,99.0,0.2308871403315361,118.35000000000001,48,47
9,9,100,True,49.0,0.03675811837737852,122.7,62,38
9,9,100,False,53.0,0.07263831466981015,,65,35
9,10,5,True,60.0,0.0,5.800000000000001,5,0
9,10,5,False,58.0,0.0,5.800000000000001,5,0
9,10,10,True,49.0,0.0,5.800000000000001,10,0
9,10,10,False,52.0,0.0,5.800000000000001,10,0
9,10,15,True,50.0,0.0,5.800000000000001,15,0
9,10,15,False,58.0,0.0,5.800000000000001,15,0
9,10,20,True,52.0,0.0,5.800000000000001,20,0
9,10,20,False,56.0,0.0,5.800000000000001,20,0
9,10,25,True,52.0,0.0,5.800000000000001,25,0
9,10,25,False,99.0,0.07725029055889106,109.80000000000001,12,13
9,10,30,True,54.0,0.0,5.800000000000001,30,0
9,10,30,False,99.0,0.10395658051287335,70.85000000000001,15,15
9,10,35,True,49.0,0.0,5.800000000000001,35,0
9,10,35,False,100.0,0.12386593220969212,66.05,17,18
9,10,40,True,53.0,0.0,5.800000000000001,40,0
9,10,40,False,100.0,0.1779322485829409,103.35000000000001,20,20
9,10,45,True,49.0,0.00028071692303634834,,32,13
9,10,45,False,100.0,0.17929670747517315,51.25,22,23
9,10,50,True,79.0,0.11247082978529102,119.35000000000001,25,25
9,10,50,False,98.0,0.16659189594169266,68.55,25,25
9,10,55,True,58.0,0.008589516639473804,142.85,14,41
9,10,55,False,95.0,0.16763232754602286,,27,28
9,10,60,True,85.0,0.1480957179041671,,30,30
9,10,60,False,100.0,0.21816765332079877,,30,30
9,10,65,True,79.0,0.1382586635855368,153.0,32,33
9,10,65,False,97.0,0.1733209106130635,97.35000000000001,32,33
9,10,70,True,77.0,0.14820742558054417,263.05,35,35
9,10,70,False,97.0,0.19220560482115673,118.95,35,35
9,10,75,True,86.0,0.1586772771382402,165.65,38,37
9,10,75,False,97.0,0.19373637125437437,104.95,37,38
9,10,80,True,88.0,0.1483370979515434,146.25,40,40
9,10,80,False,98.0,0.20137043137709973,181.10000000000002,40,40
9,10,85,True,79.0,0.15346866295573658,156.05,43,42
9,10,85,False,99.0,0.20636876799456957,58.050000000000004,42,43
9,10,90,True,61.0,0.07862707998178854,85.7,45,45
9,10,90,False,99.0,0.2178163159326219,151.25,45,45
9,10,95,True,85.0,0.16686056484206976,194.20000000000002,49,46
9,10,95,False,100.0,0.2326026599446381,140.5,47,48
9,10,100,True,50.0,0.054583532345968265,211.8,96,4
9,10,100,False,49.0,0.053280195093506726,,52,48
